	Hunmong	mongeum
天	하ᄂᆞᆯ〮	텬
地	ᄯᅡ〮	디〮
霄	하ᄂᆞᆯ〮	쇼
壤	ᄯᅡ〮	ᅀᅣᇰ〯
乾	하ᄂᆞᆯ〮	건
坤	ᄯᅡ〮	곤
宇	집	우〯
宙	집	듀〯
日	나〮	ᅀᅵᆯ〮
月	ᄃᆞᆯ	월
星	별〯	셔ᇰ
辰	별〯	신
陰	ᄀᆞ〮ᄂᆞᆯ	음
陽	볃	야ᇰ
節	ᄆᆞ〮ᄃᆡ	졀
候	긔운	후
春	봄〮	츈
夏	녀름	하
秋	ᄀᆞᅀᆞᆯ	츄
冬	겨을〮	도ᇰ
晝	낫〮	듀〯
夜	밤〮	야〯
寒	ᄎᆞᆯ〮	한
暑	더울	셔〯
晌	낫〮	샤ᇰ〯
晩	느즐〮	만〯
昏	어ᅀᅳ름	혼
暮	져믈〮	모〮
早	이를	조
晨	새배	신
曉	새배〮	효〯
曙	ᄉᆡᆯ	셔〯
朔	초ᄒᆞᄅᆞ삭
旬	열흘	슌
望	보롬〮	마ᇰ〯
晦	그〮믐〮	회〯
宵	밤〮	쇼
旦	아ᄎᆞᆷ〮	단〯
朝	아ᄎᆞᆷ〮	됴
夕	나죄	셕
歲	ᄒᆡᆺ〮	셰
年	ᄒᆡ〮	년
閏	부를〮	윤〯
臘	나펴ᇰ	납
時	ᄢᅵ니	시
晷	ᄒᆡᆺ〮귀〮	구〯
漏	루〯ᄀᆞᆨ〮	루
刻	사길	ᄀᆞᆨ
雷	울〮에〮	뢰
電	번〮게〮	뎐〯
霹	벼〮락〮	벽〮
靂	벼〮락〮	력〮
風	ᄇᆞᄅᆞᆷ	푸ᇰ
雨	비〮	우〯
霜	서리〮	사ᇰ
露	이슬〮	로〯
雪	눈〮	셜
霰	ᄡᆞ눈〯	션〯
氷	어름〮	비ᇰ
雹	무〮뤼〮	박
雲	구룸〮	운
霞	노을	하
嵐	인애	남
霧	안〯개〮	무〯
虹	므〮지게〮	홍
霓	므〮지게〮	예
蝃	므지게〮	톄〮
蝀	므〮지게〮	도ᇰ〯
霖	오란〮비	림
涷	쇠나기〮	도ᇰ〮
澇	믈〮ᄭᅳ일	로
旱	ᄀᆞ〮ᄆᆞᆯ〮	한〯
山	묏〯	산
嶽	묏부〯리〮	악〮
峯	묏보ᇰ오리〮	보ᇰ
岫	묏부〯리〮	슈
壑	굴〮허ᇰ〮	학〮
谷	골〯	곡
崖	묏언덕	애
岸	믈〮언덕	안
巖	바회〮	암
嶂	묏〯쟈ᇰ〯
嶺	재〮려ᇰ〯
峴	고개〮	현〯
崗	묏부〯리〮	가ᇰ
巓	묏부〯리〮	뎐
峒	묏골〯	도ᇰ
麓	묏기슭〮	록〮
丘	두던	구
原	두던〮	원
皐	두던〮	고
阜	두던〮	부〯
坡	두듥	파
阪	두듥〮	판〮
陵	두듥〮	르ᇰ〮
陸	두듥〮	륙〮
泥	ᄒᆞᆰ	니
土	ᄒᆞᆰ	토〮
墈	언덕	감〯
垤	므들기〮	딜〮
郊	드르〮	교
甸	드르〮	뎐
坪	드르〮	펴ᇰ
野	ᄆᆡ〮	야〯
礓	므ᇰ〯으〮리〮돌〯	가ᇰ
礫	므ᇰ〯으〮리〮돌〯	륵〮
沙	몰애〮	사
磧	쟉벼리	젹
礁	돌〯	쵸
石	돌〯	셕〮
島	셤〯	도〯
嶼	셤〯	셔〯
湖	ᄀᆞᄅᆞᆷ〮	호
海	바다〮	ᄒᆡ〯
淵	믓〮	연
川	내	쳔
溪	시〯내〯	계
澗	시〯내〮	간〯
江	ᄀᆞᄅᆞᆷ	가ᇰ
河	ᄀᆞᄅᆞᆷ	하
汀	믓〮ᄀᆞᆺ〯	뎌ᇰ
洲	믓ᄀᆞᆺ	쥬
渚	믓〮ᄀᆞᆺ〯	져〯
沚	믓〮ᄀᆞᆺ〯	지〮
濤	믓〮결〯	도
浪	믓〮결〮	라ᇰ〯
瀾	믓〮결〮	란
波	믓〮결〮	파
津	ᄂᆞᄅᆞ	진
梁	돌	랴ᇰ
潮	밀믈	됴
汐	밀믈〮	셕〮
灘	여흘	탄
瀨	여흘〮	뢰〮
湍	뉘〯누〮리〮	단
渦	뉘〯누〮리	와
浦	개〮	보〯
漵	개〮	셔〯
港	개〮	하ᇰ〯
汊	개〮	차
井	우믈〮	져ᇰ〯
泉	ᄉᆡᆷ〯	쳔
沼	못	쇼〯
塘	못〮	다ᇰ
洋	바다	야ᇰ
派	믌가ᄅᆞ〮	패
濆	믓〮ᄀᆞᆺ〯	분
涯	믓〮ᄀᆞᆺ〮	애
潭	소〮	담
湫	소〮	츄
涔	자굇믈〮	ᄌᆞᆷ
瀧	뉘〯누〮리〮	사ᇰ
沮	즌퍼〮리〮	져
洳	즌퍼〮리〮	ᅀᅧ
窪	즌퍼〮리〮	와
澤	못〮	ᄐᆡᆨ〮
洿	우ᇰ더ᇰ〮이	오
潢	우ᇰ더ᇰ〮이	화ᇰ
瀦	우ᇰ더ᇰ〮이〮	뎌
陂	우ᇰ더ᇰ〮이	피
潦	빗〮믈〮	료〯
𤄏	시위	홍
泡	거품〮	포
漚	거ᄑᆞᆷ	구
淀	즌퍼리〮	뎡〯
濼	즌퍼리〮	박〮
蕩	즌퍼〮리〮	타ᇰ〯
湄	믓〮ᄀᆞᆺ〮	미
路	길〮	로〮
途	길	도〮
徑	길〮	겨ᇰ〯
蹊	길〮	계
衢	거리〮	구
逵	거리〮	규
岔	거리〮	차
歧	거릴〮	기
堤	언〮	뎨
堰	언〮	언〯
牐	마〮글	잡〮
壩	언〯	패〮
衚	골〯	호
衕	골〯	도ᇰ〯
巷	굴헝〮	하ᇰ
陌	거리	ᄆᆡᆨ〮
關	모개	관
隘	모개	ᄋᆡᆨ
塞	ᄀᆞᆺ〯	ᄉᆡᆨ〮
徼	ᄀᆞᆺ〯	교
境	터〮	겨ᇰ〯
界	ᄀᆞᆺ〯	계〯
疆	터〮	가ᇰ
域	에ᇰ엇	역
田	받	뎐
園	위〮안〮	원
場	맏	댜ᇰ
圃	맏	보
苑	도ᇰ산	원
囿	도ᇰ산	유
林	수플	림
藪	숩	수
壟	받두듥〮	로ᇰ〯
畈	받두듥	판
畹	ᄂᆞᄆᆞᆯ받	완〯
畛	받두듥	딘
畦	이라ᇰ〮	규
疇	이라ᇰ〮	듀
畎	고라ᇰ	견
畝	이라ᇰ	모
芍	샤〮약	샥〮
藥	샤〯약〮	약〮
薔	쟈ᇰ미	쟈ᇰ
薇	쟈ᇰ밋	미
葵	규홧	규
梅	ᄆᆡ홧	ᄆᆡ
𧃐	텩〮툑〮	텩〮
䕽	텩〮툑〮	툑〮
蓮	련	련
荷	련	하
芙	년곳	부
蕖	련곳	거
槿	무구ᇰ화	근
蕣	무구ᇰ화	슌〯
梔	지짓	지
菊	구〮홧	국〮
芝	지촛〮	지
蘭	란촛〮	란
篁	대〮	화ᇰ
竹	대〮	듁
莞	요햐ᇰ	관
蓀	부들〮	손
菖	챠ᇰ포	챠ᇰ
蒲	챵폿	포
薍	달〯	란〯
荻	달〯	뎍〮
蒹	달〯	겸
萑	달〯	환
菼	달〮	담
葭	ᄀᆞᆯ〮	가
葦	ᄀᆞᆯ〮	위
蘆	ᄀᆞᆯ〮	로
𦶀	달〯	오
蓲	달〯	구
芭	반쵸	파
蕉	반쵸	쵸
菟	새〯ᅀᅡᆷ〮	토〮
蕬	새〯ᅀᅡᆷ〮	ᄉᆞ
瓠	죠로ᇰ	호
𤬛	죠로ᇰ	로
莓	잇	ᄆᆡ
苔	잇	ᄐᆡ
藫	잇	담
蘚	잇	션〯
葎	한〯삼〮	률〮
葈	돗〮고마리	시
芄	새박〯	환
薊	조바ᇰ이〮	계
苧	모시	뎌〯
麻	삼〮	마
檾	어〮저〮귀〮	겨ᇰ〯
葛	츩〮	갈〮
𦸈	하ᄂᆞᆯ〮ᄃᆞ래〮	괄
𧁾	하ᄂᆞᆯᄃᆞ래〯	루
薛	담〮쟈ᇰ이〮	벽〮
荔	담〮쟈ᇰ이〮	례〮
茺	눈비얏〮	츄ᇰ
蔚	눈비얏〮	울〮
萑	눈비얏〮	츄
蓷	눈비얏〮	퇴
蘩	ᄡᅮᆨ〮	번
艾	ᄡᅮᆨ〮	애〯
蒿	다복〮ᄡᅮᆨ〮	호
蓬	다복〮ᄡᅮᆨ〮	보ᇰ
菅	골〯	관
茅	ᄠᅱ〮	모
荑	ᄲᅵ〮유〮기〮	뎨
𧀰	솔〯옷〮	뎨
蒨	곡도숑〮	쳔〯
萱	넘ᄂᆞᄆᆞᆯ	훤
藍	족	남
葒	료〯화〮	호ᇰ
稂	ᄀᆞ랏	라ᇰ
莠	ᄀᆞ랏	유〯
稊	ᄀᆞ랏	뎨
稗	ᄀᆞ랏	패〯
薸	머구릐〮밥〮	표
萍	머구릐밥	펴ᇰ
藻	ᄆᆞᆯ〮	조〯
蘋	머구릐밥〮	빈
梧	머귀〮	오
桐	머귀〮	도ᇰ
楊	버들〮	야ᇰ
柳	버들〮	류〮
檜	젓〮나모	회〯
栢	즉〯ᄇᆡᆨ〮	ᄇᆡᆨ〮
桂	계〯피	계〯
椿	튜ᇰ나모	츈
楓	싣나모	푸ᇰ
桑	ᄲᅩᇰ나모	사ᇰ
檿	묏〮ᄲᅩᇰ	염
柘	묏〯ᄲᅩᇰ	쟈〯
檉	갯버들	뎌ᇰ
枳	ᄐᆡᆼ〮ᄌᆞ〮	기〯
荊	가ᄉᆡ〮	혀ᇰ
棘	가ᄉᆡ〮	극〮
樗	개듀ᇰ나모	뎌
㯃	옷나모	칠〮
枌	느릅〮나모	분
楡	느릅나모	유
樺	봇〮	화〯
椵	피〮나모	단〯
槐	회홧	괴
蘗	화ᇰ벽피	벽〮
楮	닥	뎌〯
構	닥	구〯
榧	비〯ᄌᆞᆺ〮	비〯
槵	모〮관쥬	환〯
槲	소리ᄎᆞᆷ〮나모	곡
栩	가랍나모	우〯
柞	가랍나모	작〮
櫟	덥갈〮나모	륵
櫯	다〯믁〮	소
松	솔〮	쇼ᇰ
籐	드ᇱ	드ᇰ
梤	므프레	ᄌᆞᆷ
㮋	산ᄆᆡ〯ᄌᆞ〮	욱〮
樲	싄대〮초〮	ᅀᅵ〯
梓	ᄀᆞ〮래나모	ᄌᆡ〯
楸	ᄀᆞ〮래〮	츄
李	외엿〮	니〯
㮏	멋	내〯
桃	복셩화	도
楙	모〯괏〮	무〯
梨	ᄇᆡ	리
栗	밤〯	률〮
檎	니ᇰ그ᇝ	금
榴	셕늇〮	류
榛	개옴	진
棗	대〯초〮	조〯
櫻	이ᄉᆞ〮랏	ᄋᆡᆼ
杏	ᄉᆞᆯ고〮	ᄒᆡᇰ〯
芧	도토〮리〯	셔〯
橡	도토〮리〯	샤ᇰ〮
栭	도토〮리〯	ᅀᅵ
梂	당아리〮	구
榠	며ᇰ〯쟛〮	며ᇰ
𣙁	며ᇰ〯쟛〮	쟈
棠	아가외〮	다ᇰ
棣	아가외〮	톄〯
柑	감ᄌᆞᆺ〮	감
柚	유〮ᄌᆞᆺ〮	유
橘	굵〮	귤〮
橙	효근〮귨〮	드ᇰ
椒	고쵸	쵸
㮕	ᄃᆞ래	ᅀᅧᆫ
梬	고〮욤〯	비ᇰ〯
柿	감〯	시〯
芡	가ᄉᆡ〮렰	감〯
䓈	기ᄉᆡ〮련	역〮
芰	말왐〯	기〯
菱	말왐〯	르ᇰ
葡	멀위	포
萄	멀위	도
㰋	큰림금	빈
𪳪	큰림금	파
苺	ᄠᅡᆯ〮기	ᄆᆡ
葚	오ᄃᆡ〮	심
枏	ᄆᆡ실〮	ᅀᅧᆷ
菂	녀ᇇ밤〯	뎍
麳	보리	ᄅᆡ
麰	보리	모
蕎	모밀	교
麥	밀〮	ᄆᆡᆨ〮
𪎭	기자ᇰ	마
穄	기자ᇰ	졔〯
黍	기자ᇰ	셔〯
稷	피〮	직〮
粳	뫼〮ᄡᆞᆯ〮	겨ᇰ
糯	ᄎᆞ〮ᄡᆞᆯ〮	나〯
秈	뫼ᄡᆞᆯ〮	션
秫	ᄎᆞᆯ〮기자ᇰ	튤〮
稻	벼〮	도
梁	ᄉᆡᇰ도ᇰ〮ᄎᆞᆯ〮	랴ᇰ
𪐄	피〮	패〯
粟	조	속〮
薏	율믜	의〯
苡	율믜	이〮
荏	듧ᄭᅢ〮	ᅀᅵᆷ〯
𧰏	변두〮	변
豌	ᄎᆞᆯ〮코ᇰ	완
豇	과ᇰ쟈ᇰ이〮	가ᇰ
荳	ᄑᆞᆺ〮	두〮
菽	코ᇰ	슉〮
茄	가지	가
苽	외	과
葱	파	초ᇰ
蒜	마ᄂᆞᆯ	숸
韮	염교	구
薤	부ᄎᆡ	혜
蕺	멸	즙
荀	듁슌	슌
蔘	더덕	ᄉᆞᆷ
𦬸	삽듀	튤
藜	도ᄐᆞ랏	례
莧	비를	현
䓴	버슷	ᅀᅧᆫ
栮	버슷	ᅀᅵ
蕈	버슷	심
菌	버슷	균
䓀	도랏	길
莄	도랏	겨ᇰ
芫	고ᄉᆡ	원
荽	고ᄉᆡ	슈
匏	박	포
蓼	엿귀	료
茴	회햐ᇰ	회
芹	미나리	근
蘿	댓무ᅀᅮ	라
蔔	댓무ᅀᅮ	복
蔓	쉿무ᅀᅮ	만
菁	쉿무ᅀᅮ	쳐ᇰ
菘	ᄇᆡᄎᆡ	쇼ᇰ
薺	나ᅀᅵ	졔
芋	토란	우
蓴	슌	쓘
苜	게유목	목
蓿	게유목	슉
薯	마	셔
蕷	마	여
芥	계ᄌᆞᆺ	개
薑	ᄉᆡᇰ야ᇰ	ᄭᅡᆼ
蘑	표고	마
菇	표곳	고
蘘	야ᇰ핫	야ᇰ
蒡	우와ᇰ	바ᇰ
萵	부루	와
苣	부루	거
蕨	고사리	궐
虌	고사리	별
藕	년ᄭᆞᆫ	우
蘇	ᄎᆞ소기	소
菠	시근ᄎᆡ	파
蔆	시근ᄎᆡ	르ᇰ
莙	근대	군
𦼫	샤라부루	거
蕒	샤라부루	ᄆᆡ
𫉖	올미	ᄇᆞᆯ
𫊖	올미	졔
蔢	박핫	파
𦽅	박핫	하
芣	뵈ᄧᅪᇰ이	부
苢	뵈ᄧᅪᇰ이	이
蔞	믈ᄡᅮᆨ	루
葵	아옥	규
葇	뇌야기	ᅀᅲ
萞	피마ᄌᆞ	비
鳳	보ᇰ화ᇰ	보ᇰ
凰	보ᇰ화ᇰ	화ᇰ
鸞	란둇	란
鶴	학	학
鴻	긔려기	호ᇰ
鴈	긔려기	안
𦉓	너ᅀᅵ	부
鵠	고해	곡
𪀚	도로ᇰ태	쇼ᇰ
鶻	매	골
鷹	매	으ᇰ
隼	매	쥰
鵂	부훠ᇰ이	휴
鶹	부훠ᇰ이	류
鴞	부훠ᇰ이	효
鵩	부훠ᇰ이	복
鵰	수리	됴
鷲	수리	츄
鸛	한새	관
⿱牧鳥	다와기	목
𪅖	오과리	좌ᇰ
鷸	도요	휼
鵚	므수리	독
鶖	므수리	츄
𪄉	할미새	오ᇰ
𪆂	할미새	거
鶺	할미새	쳑
鴒	할미새	려ᇰ
鵓	집비두리	ᄇᆞᆯ
鴿	집비두리	합
鴷	뎌고리	렬
鳩	비두리	구
鷂	새매	요
鸇	새매	젼
鷐	새매	신
𩘲	새매	푸ᇰ
𪇔	루미	ᄌᆞ
䳓	두루미	로
鵜	사ᄃᆞ새	뎨
鶘	사ᄃᆞ새	호
鷄	ᄃᆞᆰ	계
雉	ᄭᅯᇰ	티
鵝	거유	아
鴨	올히	압
鴡	즤ᇰ거ᇰ이	져
鷗	ᄀᆞᆯ며기	구
⿰舒鳥	믓올히	셔
鳧	믓올히	부
鷦	볍새	쵸
鷯	볍새	료
鶬	아리새	차ᇰ
鶊	아리새	겨ᇰ
烏	가마괴	오
鴉	ᄀᆞᆯ가마괴	아
鸒	ᄀᆞᆯ가마괴	여
𪆁	ᄀᆞᆯ가마괴	ᄉᆞ
隹	새	쵸
雀	새	쟉
梟	옫바미	효
鷁	ᄇᆞᄅᆞᆷ가비	ᄋᆡᆨ
鷰	져비	연
鳦	져비	을
鸚	곳고리	ᄋᆡᆼ
鸝	곳고리	례
鳲	버국새	시
𪀗	버국새	궤
鴶	버국새	알
鵴	버국새	국
鷸	모ᄎᆞ라기	암
鶉	모ᄎᆞ라기	슌
鳶	쇠로기	연
鴟	쇠로기	치
鵲	가치	쟉
鷽	댓가치	ᄒᆞᆨ
鳺	졉동새	규
鵑	졉도ᇰ새	견
鸂	믓ᄃᆞᆰ	계
鷘	믓ᄃᆞᆰ	틱
鷺	하야로비	로
鷥	하야로비	ᄉᆞ
翡	쇠새	비
翠	쇠새	취
鸚	ᄋᆡᆼ무	ᄋᆡᆼ
鵡	ᄋᆡᆼ뭇	무
鴦	원아ᇰ	원
鴦	원아ᇰ	아ᇰ
鸕	가마오디	로
鶿	가마오디	ᄌᆞ
麒	긔린	긔
麟	긔린	린
虎	갈웜	호
豹	표엄	표
象	고키리	샤ᇰ
獅	ᄉᆞᄌᆡᆺ	ᄉᆞ
狻	ᄉᆞᄌᆡ	산
猊	삿기	예
獐	노ᄅᆞ	쟈ᇰ
麕	노ᄅᆞ	균
麅	고라니	포
麝	샤햐ᇰ노ᄅᆞ	샤
麋	사ᄉᆞᆷ	미
鹿	사ᄉᆞᆷ	록
麀	사ᄉᆞᆷ	우
麛	삿기	미
豺	스ᇰ랴ᇰ이	싀
狼	일히	라ᇰ
獱	너ᇰ우리	빈
獺	너ᇰ우리	달
獼	납	미
猴	납	후
猢	납	호
猻	납	손
犀	므쇼	셔
貂	돈피	툐
豨	돋	희
貓	괴	묘
駒	ᄆᆞ야지	구
犢	쇼ᇰ아지	독
猩	ᄉᆡᇰᄉᆡᇰ이	셔ᇰ
猿	납	원
𦍩	염쇼	고
䍽	염쇼	력
羊	야ᇰ	야ᇰ
羔	삿기	고
猪	돋	뎨
豕	돋	시
彘	돋	톄
豚	삿기	돈
貉	우슭	학
貆	삿기	훤
狐	여으	호
狸	ᄉᆞᆰ	리
熊	곰	우ᇰ
羆	곰	비
𩧐	약대	락
駝	약대	타
狗	가히	구
獒	큰가히	오
犬	가히	견
厖	더펄가히	바ᇰ
馬	ᄆᆞᆯ	마
牛	쇼	우
驢	나귀	려
騾	노새	로
猯	오ᅀᆞ리	단
獾	담뵈	환
兎	톳기	토
蝟	고솜돋	위
鼢	두디쥐	분
鼠	쥐	셔
鼯	ᄃᆞ라미	오
鼪	ᄃᆞ라미	ᄉᆡᇰ
龍	미르	료ᇰ
龜	거붑〮	귀
黿	쟈래	원
鼈	쟈래	별
螃	게〯	바ᇰ
蠏	게〯	ᄒᆡ
蠣	굴〮	려〯
蟶	가리〮맏〮	뎌ᇰ
鰕	새요	하
𧵅	쟈개	파〯
蚌	ᄉᆡᇰ포	바ᇰ〯
鰒	ᄉᆡᇰ포	박
蛤	죠개	합〮
蜊	죠개	리
蜃	죠개	슌〯
𧖙	가막죠개	현〯
鯨	고래	겨ᇰ
鯢	고래	예
鰱	련어	련
魴	바ᇰ어	바ᇰ
鰻	ᄇᆡ얌댜ᇰ어	만
鱺	ᄇᆡ얌댜ᇰ어	리
鰍	믯구리〮	츄
鱔	드렁허리	션
鮒	부〯어	부〯
鯽	부어	즉
鱖	소가〮리〮	궐〮
鰳	쥰〯티	륵〮
鯔	슈〯어	츼
鰷	ᄇᆡ어	됴
鯖	비욷	쳐ᇰ
鱧	가모〮티	례
魺	복	하
魨	복	돈
鮎	메유기〮	념
鰋	메유기〮	언〯
鯊	사ᇰ엇	사
鱸	로어	로
鯼	조긔〮	조ᇰ
鯉	리〯어	리〯
蜘	거믜	디
蛛	거믜	듀
蚇	자재	쳑
蠖	자재	확
蛉	ᄌᆞᆫ자리	려ᇰ
蛚	ᄌᆞᆫ자리	렬
蜻	ᄌᆞᆫ자리	쳐ᇰ
蜓	ᄌᆞᆫ자리	뎌ᇰ
蠨	ᄀᆞᆯ거믜	쇼
蛸	ᄀᆞᆯ거믜	쇼
蟢	ᄀᆞᆯ거믜	희
螯	가재	오
蛺	나ᄇᆡ	협
蝶	나ᄇᆡ	뎝
蛾	나ᄇᆡ	아
螢	반도	혀ᇰ
蚯	거ᅀᅱ	구
蚓	거ᅀᅱ	인
蛐	거ᅀᅱ	곡
蟮	거ᅀᅱ	션
蠐	굼버ᇰ이	졔
螬	굼버ᇰ이	조
蝸	ᄃᆞᆯ파ᇰ이	과
蠅	ᄑᆞ리	스ᇰ
蛇	ᄇᆡ얌	샤
蟒	구려ᇰ이	마ᇰ
虺	독샤	훼
蝮	독샤	복
蠆	젼길	태
蠍	젼갈	헐
蚊	모긔	문
虻	드ᇰ의	ᄆᆡᇰ
𧑓	쥐며느리	셔
蝜	쥐며느리	부
蛜	쥐며느리	이
蝛	쥐며느리	위
蠷	그르메너흐리	구
螋	그르메너흐리	수
蜣	ᄆᆞᆯᄯᅩᇰ구으리	가ᇰ
蜋	ᄆᆞᆯᄯᅩᇰ구으리	랴ᇰ
蟼	머구리	겨ᇰ
黽	머구리	며ᇰ
蛙	머구리	와
蟈	머구리	국
蜩	ᄆᆡ야미	됴
蟬	ᄆᆡ야미	션
螓	ᄆᆡ야미	진
螗	ᄆᆡ야미	다ᇰ
蚰	지차리	유
蜒	지차리	연
蚕	누에	ᄌᆞᆷ
蛹	본도기	요ᇰ
蝙	ᄇᆞᆰ쥐	편
蝠	ᄇᆞᆰ지	복
螳	다ᇰ의야지	다ᇰ
螂	다ᇰ의야지	라ᇰ
螻	도로래	루
蛄	도로래	고
蟫	반대좀	담
螕	진뒤	비
蜈	지네	오
蚣	지네	고ᇰ
蛭	거머리	딜
蟥	거머리	화ᇰ
蜤	되료ᇰ	셕
蜴	되료ᇰ	텩
蠑	도마ᄇᆡ얌	여ᇰ
蚖	도마ᄇᆡ얌	원
螞	묏도기	마
蚱	묏도기	자
蝗	묏도기	화ᇰ
螽	묏도기	죠ᇰ
螺	골와ᇰ이	라
螄	골와ᇰ이	ᄉᆞ
螌	갈외	반
蝥	갈외	모
蟋	귓도라미	실
蟀	귓도라미	솔
蟻	가야미	의
蛬	귓도라미	고ᇰ
虼	벼록	걸
蚤	벼록	조
蟣	혀	긔
蝨	니	슬
蜉	ᄒᆞᄅᆞ사리	부
蝣	ᄒᆞᄅᆞ사리	유
蠛	누네노리	멸
蠓	누네노리	모ᇰ
蛆	귀더기	져
蜂	벌	보ᇰ
蛀	좀	쥬
蠹	좀	두
蚮	ᄃᆡ못	ᄃᆡ
蝐	ᄃᆡ못	모
蠮	바ᄃᆞ리	예
螉	바ᄃᆞ리	오ᇰ
蝦	머구리	하
蟆	머구리	마
蟾	두터비	셤
蜍	두터비	여
蝌	올차ᇰ이	과
蚪	올차ᇰ이	두
蛞	올차ᇰ이	활
𧓕	올차ᇰ이	도ᇰ
身	몸	신
貌	즛	모
肢	ᄉᆞ짓	지
體	몸	톄
顔	ᄂᆞᆺ	안
面	ᄂᆞᆺ	면
形	얼굴	혀ᇰ
容	즛	요ᇰ
頭	머리	두
首	마리	슈
頂	뎌ᇰ바기	뎌ᇰ
䪿	가마	신
額	니마	ᄋᆡᆨ
顱	ᄃᆡ골	로
顁	니마	뎌ᇰ
䫙	니마	사ᇰ
顋	ᄲᅡᆷ	싀
頰	보죠개	협
顴	ᄲᅣᆷ	관
臉	ᄂᆞᆺ	렴
𩓐	목	ᄇᆞᆯ
頸	목	겨ᇰ
脰	목	두
項	목	하ᇰ
眼	눈	안
目	눈	목
睛	눈ᄌᆞᅀᆡ	쳐ᇰ
瞳	누ᇇ부텨	도ᇰ
眸	누ᇇ마ᇰ올	모
瞼	누ᇇ두에	검
眉	눈섭	미
睫	눈시올	쳡
鬢	구믿	비ᇰ
頤	ᄐᆞᆨ	이
頷	ᄐᆞᆨ	함
頦	ᄐᆞᆨ	ᄒᆡ
胳	쟈개얌	각
腋	쟈개얌	ᄋᆡᆨ
肋	녑발치	륵
脇	녑구레	협
肩	엇개	견
臑	엇게	뇨
腢	엇게	우
胛	엇게	갑
拳	주머귀	권
腡	손금	과
肐	ᄑᆞᆯ	걸
膊	ᄑᆞᆯ독	박
口	입	구
舌	혀	셜
脣	입시울	슌
吻	입아괴	믄
牙	엄	이
齒	니	치
齗	닛믜임	은
腭	거훔	악
肱	ᄑᆞᆯ	괴ᇰ
臂	ᄑᆞᆯ	비
手	손	슈
掌	소ᇇ바독	쟈ᇰ
指	소ᇇ가락	지
爪	소ᇇ돕	조
肘	ᄑᆞᆯ구브러ᇰ	듀
腕	손목	완
腓	허튀	비
踦	허튀	긔
腨	허튓 ᄇᆡ	쳔
臁	허튓 녑	렴
脛	허튓 ᄲᅧ	혀ᇰ
胻	허튓 ᄲᅧ	ᄒᆡᇰ
骹	허튓 ᄲᅧ	교
骭	허튓 ᄲᅧ	한
喉	목ᄭᅮ무	후
嚨	목ᄭᅮ무	로ᇰ
咽	목ᄭᅮ무	연
嗓	목쥴뒤	사ᇰ
耳	귀	ᅀᅵ
𦖋	귓구무	타
鼻	고	비
準	곳ᄆᆞᄅᆞ	쥰
心	념토ᇰ	심
肝	가ᇇ〮	간
脾	말하	비
肺	부화	폐
膓	애	댜ᇰ
胃	야ᇰ	위
膽	ᄡᅳᆯ게	담
腎	코ᇰᄑᆞᆺ	신
胸	가ᄉᆞᆷ	휴ᇰ
膛	가ᄉᆞᆷ	다ᇰ
膺	가ᄉᆞᆷ	으ᇰ
臆	가ᄉᆞᆷ	억
軀	몸	구
膈	가ᄉᆞᆷ	격
嬭	졋	내
乳	졋	ᅀᅲ
毗	ᄇᆡᆺ복	비
胦	ᄇᆡᆺ복	아ᇰ
脖	ᄇᆡᆺ복	발
臍	ᄇᆡᆺ복	졔
背	드ᇰ	ᄇᆡ
脊	드ᇰᄆᆞᄅᆞ	쳑
腰	허리	요
膂	허리	려
腿	싄다리	퇴
胯	다리	과
髀	다리	비
股	다리	고
尻	오미뇌	고
脽	오미뇌	슈
臀	믿	둔
肛	믿	하ᇰ
膝	무룹	슬
膕	무룹	국
𦚼	오곰	곡
䐐	오곰	츄
尿	오좀	뇨
脬	오좀ᄭᅢ	포
膀	오좀ᄭᅢ	바ᇰ
胱	오좀ᄭᅢ	과ᇰ
髮	터럭	발
鬚	입거웃	슈
髭	거웃	ᄌᆞ
髥	거웃	ᅀᅧᆷ
肚	ᄇᆡ	두
腹	ᄇᆡ	복
腔	구레	가ᇰ
𦚞	구레	과ᇰ
呼	숨 내쉴	호
吸	숨 드리쉴	흡
脉	ᄆᆡᆨ	ᄆᆡᆨ
息	숨	식
肌	ᄉᆞᆯ	긔
膚	ᄉᆞᆯ	부
腠	ᄉᆞᆯᄭᅳᆷ	주
膜	기름갓	막
髑	머릿ᄃᆡ골	독
髏	머릿ᄃᆡ골	루
腦	골치	노
髓	골치	슈
骸	ᄲᅧ	ᄒᆡ
骨	ᄲᅧ	골
骴	ᄲᅧ	ᄌᆞ
骼	ᄲᅧ	각
跟	뒤측	근
踵	뒤측	죠ᇰ
跗	밧드ᇰ	부
踝	귀머리	과
拇	엄지가락	모
趾	발	지
足	발	죡
脚	발	각
躬	몸	구ᇰ
影	그르메	여ᇰ
音	소ᄅᆡ	음
聲	소ᄅᆡ	셔ᇰ
性	셔ᇰ	셔ᇰ
情	ᄠᅳᆮ	져ᇰ
志	ᄠᅳᆮ	지
意	ᄠᅳᆮ	의
哭	울	곡
泣	울	읍
笑	우ᅀᅮᆷ	쇼
唒	우ᅀᅳᆯ	신
噦	피기	얼
噫	트림	애
噴	ᄌᆞᄎᆡ욤	분
嚏	ᄌᆞᄎᆡ욤	톄
鬍	거츨	호
禿	믤	독
肨	ᄉᆞᆯ질	파ᇰ
臞	여윌	구
𥆖	누ᇇ곱	두
眵	눈곱	치
齈	콧물	노ᇰ
涕	곳믈	톄
沫	거품	말
淚	눈믈	류
涶	춤	타
涎	춤	연
膿	골믈	노ᇰ
血	피	혈
液	진	ᄋᆡᆨ
汗	ᄯᆞᆷ	한
齙	니버들	포
瞎	눈멀	할
矬	킈쟐글	좌
矮	킈쟈글	애
齇	쥬복고	차
皰	쥬복	포
齆	고 머글	오ᇰ
鼾	고 코을	한
溲	오좀	수
便	오좀	편
𡱁	ᄯᅩᆼ	시
糞	ᄯᅩᆼ	분
屄	구무	비
屄	구무	쥬
屁	밋구무	피
䊧	바ᇰ귀	비
眠	조오롬	면
睡	잘	슈
夢	ᄭᅮᆷ	모ᇰ
覺	ᄭᆡᆯ	교
欠	하외욤	흠
伸	기지게	신
寤	ᄭᆡᆯ	오
寐	잘	ᄆᆡ
祖	하나비	조
父	아비	부
爹	아비	다
爺	아비	야
媽	할미	마
婆	할미	파
考	아비	고
妣	어미	비
母	어미	모
孃	어미	냐ᇰ
妻	겨집	쳐
妾	고마	쳡
妯	겨집도ᇰ셰	튝
娌	겨집도ᇰ셰	리
娣	겨집동셰	뎨
姒	겨집도ᇰ셰	ᄉᆞ
男	아ᄃᆞ	남
女	겨집	녀
夫	샤오ᇰ	부
婦	며느리	부
嫡	뎍실	뎍
蘖	셔얼	얼
眷	권쇽	권
族	아ᅀᆞᆷ	족
妗	아ᄌᆞ미	금
嫂	아ᄌᆞ미	수
嬸	아ᄌᆞ미	심
娘	겨집	냐ᇰ
舅	아자비	구
姑	아ᄌᆞ미	고
伯	ᄆᆞᆮ아자비	ᄇᆡᆨ
叔	아ᅀᆞ아자비	슉
兄	ᄆᆞᆮ	혀ᇰ
哥	ᄆᆞᆮ	가
昆	ᄆᆞᆮ	곤
弟	아ᅀᆞ	뎨
姨	아ᄌᆞ미	이
姐	ᄆᆞᆮ누의	져
姉	ᄆᆞᆮ누의	ᄌᆞ
妹	아ᅀᆞ누의	ᄆᆡ
兒	아ᄒᆡ	ᅀᆞ
童	아ᄒᆡ	도ᇰ
囝	아ᄃᆞᆯ	견
子	아ᄃᆞᆯ	ᄌᆞ
姪	아ᄎᆞ아ᄃᆞᆯ	딜
孫	손ᄌᆞ	손
甥	아ᄎᆞ아ᄃᆞᆯ	ᄉᆡᇰ
壻	사회	셔
孾	아ᄒᆡ	여ᇰ
孩	아ᄒᆡ	ᄒᆡ
齠	니ᄀᆞᆯ	툐
齔	니ᄀᆞᆯ	친
幼	져믈	유
冲	져믈	튜ᇰ
孺	져믈	ᅀᅲ
稚	져믈	티
姓	셔ᇰ	셔ᇰ
氏	각시	시
名	일훔	며ᇰ
號	일훔	호
親	아ᅀᆞᆷ	친
戚	아ᅀᆞᆷ	쳑
宗	ᄆᆞᄅᆞ	조ᇰ
系	간	계
奴	남진죠ᇰ	노
婢	겨집죠ᇰ	비
僮	죠ᇰ	도ᇰ
僕	죠ᇰ	복
姆	졋어미	모
嫗	할미	구
姥	할미	모
媼	할미	오
鰥	호을아비	환
寡	호을어미	과
嫠	호을어미	리
孀	호을어미	사ᇰ
翁	하나비	오ᇰ
叟	하나비	수
耆	늘글	기
老	늘글	로
婚	사돈	혼
姻	사돈	인
嫁	얼일	가
娶	어를	ᄎᆔ
精	솝	져ᇰ
氣	긔운	ᄭᅴ
孕	ᄇᆡᆯ	이ᇰ
毓	도읠	육
姙	ᄇᆡᆯ	ᅀᅵᆷ
娠	ᄇᆡᆯ	신
娩	나ᄒᆞᆯ	면
産	나ᄒᆞᆯ	산
㝈	ᄀᆞᆯ오기	솬
⿰孛殳	졋머길	뉴
鞠	칠	국
育	칠	육
庠	ᄒᆞᆨ〮다ᇰ	샤ᇰ〮
序	ᄒᆞᆨ〮다ᇰ	셔〯
校	ᄒᆞᆨ〮다ᇰ	교〯
塾	ᄒᆞᆨ〮다ᇰ	슉〮
師	스스ᇰ	ᄉᆞ
傅	스스ᇰ	부〮
生	날	ᄉᆡᇰ
徒	물〮	도
詩	글〯월〮	시
書	글〮월〮	셔
易	밧ᄭᅩᆯ〮	역
禮	례〮수〯	례〮
科	무들기〮	과
第	ᄎᆞ〮례	뎨〯
儁	ᄂᆞᆯ〮날〮	쥰〯
儒	션븨	ᅀᅲ
章	글〮월〮	쟈ᇰ
句	굿〮굿〮	구〯
文	글〮월〮	문
字	글월〮	ᄌᆞ
典	글월〮	뎐〯
籍	글〮월〮	젹〮
經	글〮월〮	겨ᇰ
史	ᄉᆞ긧	ᄉᆞ〮
冊	ᄎᆡᆨ〮	ᄎᆡᆨ〮
篇	글〮월〮	편〮
卷	궈ᇇ〯	권〯
帙	ᄎᆡᆨ〮읫	딜〮
筆	붇〯	필〮
墨	먹〮	믁〮
硯	벼로〮	연〮
紙	죠ᄒᆡ〮	지〮
表	밧	표
箋	글〮월〮	젼
命	목숨〯	며ᇰ〯
諭	알욀〮	유〯
詔	죠셧	죠
勅	틱〮셔〮	틱〮
誥	알욀〮	고
旨	ᄠᅳᆮ	지
榜	바ᇱ〯	바ᇰ〯
令	긔걸〮ᄒᆞᆯ	려ᇰ〮
法	법〮	법〮
例	례〯ᄉᆞᆺ〮	례〯
符	보〮람〯	부
契	글〮월〮	계〯
印	인〮	인〮
璽	인〮	ᄉᆞ〯
簡	글〮월〮	간〯
帖	브틸〮	텹〮
案	글월〮	안〯
牘	글〮월〮	독
疏	글〮월〮	소〯
箚	글〮월〮	잡〮
奏	엳〯ᄌᆞ〮올〮	주〯
啓	엳〯ᄐᆞᆯ〮	계〯
狀	얼굴	자ᇰ〯
呈	바틸〮	뎌ᇰ
牌	글〮월〮	패
引	혈〮	인〮
簿	글월〮	부〯
牒	글〮월〮	텁〮
稿	글〮초〮	고〯
批	글〮월〮	피〮
皇	님굼	화ᇰ
帝	님굼	뎨
君	님굼	ᄭᅮᆫ
主	님	쥬
后	듀ᇰ구ᇰ	후
妃	듀ᇰ구ᇰ	비
嬪	비ᇱ	비ᇰ
嬙	시녓	쟈ᇰ
儲	여툴	뎌
副	버글	부
世	누리	셰
代	ᄀᆞᄅᆞᄎᆞᆯ	ᄃᆡ
邦	나라	바ᇰ
國	나라	국
辟	님굼	벽
王	님굼	와ᇰ
公	구의	고ᇰ
侯	님굼	후
宰	ᄌᆡ샤ᇰ	ᄌᆡ
相	ᄌᆡ샤ᇰ	샤ᇰ
將	쟈ᇰ슈	쟈ᇰ
帥	쟈ᇰ슛	슈
駙	부맛	부
卿	벼슬	겨ᇰ
臣	신핫	신
僚	도ᇰ관	료
員	관원	원
吏	셔릿	리
士	됴ᄉᆞᆺ	ᄉᆞ
隷	거러치	예
民	ᄇᆡᆨ셔ᇰ	민
氓	ᄇᆡᆨ셔ᇰ	ᄆᆡᆼ
閹	고쟈	엄
宦	고쟈	환
閽	고쟈	혼
䦙	고쟈	시
卒	군ᄉᆞ	졸
伍	군ᄉᆞ	오
軍	군ᄉᆞᆺ	군
丁	ᄉᆞᆫ	뎌ᇰ
泅	헤욤	슈
㴹	므ᄌᆞ밋	미
游	헤욤	유
泳	므ᄌᆞ미	여ᇰ
傭	삭바ᄃᆞᆯ	요ᇰ
雇	삭바ᄃᆞᆯ	고
匠	쟈ᇰᅀᅵᆫ	쟈ᇰ
役	브릴	역
漁	고기 자블	어
獵	산ᄒᆡᇰᄒᆞᆯ	렵
樵	나모 뷜	쵸
牧	모ᅀᅵᆯ	목
染	므드릴	ᅀᅧᆷ
畵	그릴	화
筭	혤	산
曆	ᄎᆡᆨ력	력
神	신려ᇰ	신
佛	부텨	불
鬼	귓것	귀
魔	귓것	마
仙	션ᅀᅵᆫ	션
道	도ᄉᆞᆺ	도
尼	스ᇰ	니
僧	쥬ᇰ	스ᇰ
賓	손	비ᇰ
客	손	ᄀᆡᆨ
覊	나ᄀᆞ내	긔
旅	나ᄀᆞ내	려
伴	벋	반
侶	벋	려
友	벋	우
朋	벋	부ᇰ
娼	녀계	챠ᇰ
妓	녀계	기
䘕	녀계	하ᇰ
衏	녀계	원
傀	광대	괴
儡	광대	뢰
優	노ᄅᆞᆺ바치	우
伶	노ᄅᆞᆺ바치	려ᇰ
醫	의원	의
卜	졈복	복
呪	굴	츅
儈	즈름	회
商	흐ᇰ져ᇰ홀	샤ᇰ
賈	흐ᇰ져ᇰᄒᆞᆯ	고
農	녀름지ᅀᅳᆯ	노ᇰ
工	고ᇰ쟈ᇰ바치	고ᇰ
巫	무다ᇰ	무
覡	화라ᇰ이	혁
媒	듀ᇰᅀᅵᆫ	ᄆᆡ
妁	듀ᇰᅀᅵᆫ	쟉
瞽	쇼겨ᇰ	고
瞍	쇼겨ᇰ	수
盲	쇼겨ᇰ	ᄆᆡᇰ
矇	쇼겨ᇰ	모ᇰ
東	도ᇰ녁	도ᇰ
夷	되	이
西	셧녁	셔
戎	되	융
南	앏	남
蠻	되	만
狄	되	뎍
倭	예	와
韃	다대	달
羗	되	가ᇰ
虜	되	로
刦	후릴	겁
盜	도ᄌᆞᆨ	도
寇	도ᄌᆞᆨ	구
賊	도ᄌᆞᆨ	적
宮	집	구ᇰ
闕	집	궐
宸	집	신
殿	집	뎐
屋	집	옥
宅	집	ᄐᆡᆨ
家	집	가
房	집	바ᇰ
廳	집	텨ᇰ
廨	집	ᄒᆡ
廬	집	려
舍	집	샤
閨	도자ᇰ	규
閤	도자ᇰ	합
室	집	실
堂	집	다ᇰ
樓	다락	루
閣	집	각
亭	뎌ᇰᄌᆞᆺ	뎌ᇰ
臺	ᄃᆡᆺ	ᄃᆡ
闈	문	위
闥	문	달
廡	집	무
廊	ᄒᆡᇰ라ᇰ	라ᇰ
厦	집	하
寢	몸채	침
埇	듕계	요ᇰ
𨹸	챠면	담
𪗆	집	ᄌᆡ
院	집	원
廠	허간	챠ᇰ
棚	가개	부ᇰ
軒	듸누리	헌
檻	듸누리	함
欄	란간	란
楯	쳐ᇰ널	슌
戶	입	호
牖	차ᇰ	유
䆫	차ᇰ	차ᇰ
欞	듀ᇰ긷	려ᇰ
壁	ᄇᆞᄅᆞᆷ	벽
墉	담	요ᇰ
垣	담	원
墻	담	쟈ᇰ
桁	도리	ᄒᆡᇰ
檁	납	름
簷	기슭	쳠
甍	기슭	ᄆᆡᇰ
溝	쉬구ᇰ	구
渠	쉬구ᇰ	거
瀆	쉬구ᇰ	독
𤅋	쉬구ᇰ	두
厠	뒷〯간〮ᄎᆞ〮
㢏	매유토ᇰ	투
圂	뒷간	혼
圊	뒷간	쳐ᇰ
牔	박고ᇰ	박
櫳	차ᇰ살	로ᇰ
梐	살문	폐
枑	살문	호
陛	버터ᇰ	폐
墀	ᄠᅳᆯ	디
階	섬	계
庭	ᄠᅳᆯ	뎌ᇰ
棟	ᄆᆞᄅᆞ	도ᇰ
樑	보	랴ᇰ
楹	기도ᇰ	여ᇰ
柱	기도ᇰ	듀
梲	대고ᇰ	졀
椽	셔	연
桷	셔	각
榱	셔	최
礎	쥬츄	초
磉	쥬츄	사ᇰ
礩	쥬츄	질
磶	쥬츄	셕
藩	울	번
柵	세댜ᇰ	ᄎᆡᆨ
笆	바조	파
籬	바조	리
門	문	문
扉	문ᄧᅡᆨ	비
椳	지도리	외
樞	지도리	츄
扃	쟈ᇰ군목	겨ᇰ
𣟴	쟈ᇰ군목	솬
扊	쟈ᇰ군목	염
扅	쟈ᇰ군목	이
𨴑	문젼	과ᇰ
闑	무ᇇ돌	얼
閫	문젼	곤
閾	문젼	역
橋	ᄃᆞ리	교
梯	ᄃᆞ리	뎨
矼	ᄃᆞ리	가ᇰ
徛	ᄃᆞ리	긔
朝	됴횟	됴
廷	터	뎌ᇰ
京	셔울	겨ᇰ
都	도읍	도
邊	ᄀᆞᆺ	변
鄙	ᄀᆞᆺ	비
寰	고을	환
畿	겨ᇰ긧	긔
部	거느릴	부
署	마ᅀᆞᆯ	셔
曹	마ᅀᆞᆯ	조
局	마ᅀᆞᆯ	국
官	구의	관
府	마ᅀᅳᆯ	부
衙	마ᅀᆞᆯ	아
司	마ᅀᆞᆯ	ᄉᆞ
州	고을	쥬
郡	고을	군
縣	고을	현
邑	고을	읍
衛	ᄢᅳ릴	위
所	바	소
營	바오달	여ᇰ
廂	집	샤ᇰ
邸	집	뎨
店	져제	뎜
埠	져제	부
集	모ᄃᆞᆯ	집
街	거리	개
市	져제	시
廛	져제	뎐
行	져제	하ᇰ
屯	군모들	둔
堡	쟈근 잣	보
壕	ᄒᆡᄌᆞ	호
池	못	디
郛	밧 잣	부
郭	밧 잣	곽
城	잣	셔ᇰ
隍	ᄒᆡᄌᆞ	화ᇰ
閭	ᄆᆞᅀᆞᆯ	려
閻	ᄆᆞᅀᆞᆯ	염
鄰	ᄆᆞᅀᆞᆯ	린
里	ᄆᆞᅀᆞᆯ	리
寨	목ᄎᆡᆨ	채
墅	노ᇰ솟	셔
村	ᄆᆞᅀᆞᆯ	촌
鄕	스굴	햐ᇰ
墩	ᄒᆞᆰ무디	돈
堠	댜ᇰ수ᇰ	후
烽	보ᇰ호	보ᇰ
燧	보ᇰ호	슈
舘	집	관
驛	역	역
站	역	참
鋪	역	푸
倉	차ᇰ	차ᇰ
厫	채	오
囤	노젹	돈
篅	노젹	쳔
囷	노젹	균
廩	고	름
帑	금으ᇇ고	타ᇰ
庫	곳	고
牢	옥	뢰
獄	옥	옥
囹	옥	려ᇰ
圄	옥	어
窨	움	음
窩	산막	와
穽	함져ᇰ	져ᇰ
窖	굳	교
陶	딜구을	도
窰	왜욧	요
囱	굴	초ᇰ
堗	굴	돌
庖	브ᅀᅥᆨ	포
廚	브ᅀᅥᆨ	듀
炕	구들	가ᇰ
竈	브ᅀᅥᆨ	조
庵	뎔	암
觀	집	관
寺	뎔	ᄉᆞ
刹	뎔	찰
祠	ᄉᆞ다ᇰ	ᄉᆞ
廟	조ᇰ묫	묘
壇	졔터	단
壝	졔터	유
鼎	솓	뎌ᇰ
鑊	솓	확
鼐	솓	내
鼒	솓	ᄌᆞ
釜	가마	부
鍋	가마	과
𩰿	가마	심[1]
錡	가마	긔
樻	궷	궤
櫝	골	독
庋	자ᇰ	기
机	도마	궤
牀	펴ᇰ사ᇱ	사ᇰ
榻	펴ᇰ사ᇰ	탑
凳	사오리	드ᇰ
椅	교의	의
卓	고죡사ᇰ	탁
盤	반	ᄲᅡᆫ
榼	합	합
鏊	노고	오
簁	체	싀
籮	체	라
甑	시르	즈ᇰ
箅	시르 믿	비
盌	사발	원
楪	뎝시	뎝
簞	바고니	단
箕	키	긔
匕	술	비
匙	술	시
筴	져	협
筯	져	뎌
砑	밀돌	아
碾	밀돌	년
磨	매	마
磑	매	의
碓	바ᇰ하	ᄃᆡ
臼	호왁	구
砧	버터ᇰ	팀
杵	고	져
筵	돗	연
席	돗	셕
茵	지즑	인
薦	지즑	쳔
兀	바ᇰ사오리	올
簟	삳	뎜
枕	벼개	침
褥	요	ᅀᅭᆨ
秤	저울	치ᇰ
衡	저욼대	혀ᇰ
錘	ᄃᆞ림	튜
權	ᄃᆞ림	권
升	되	스ᇰ
斗	말	두
槩	펴ᇰ목	개
斛	고	곡
糨	ᄡᆞᆯ플	가ᇰ
糊	밀플	호
膠	갓ᄲᅳᆯ	교
蠟	밀	랍
𣑿	붑마치	부
柲	ᄌᆞᄅᆞ	필
柄	ᄌᆞᄅᆞ	벼ᇰ
𣠽	ᄌᆞᄅᆞ	파
樽	주ᇇ	준
罍	준	뢰
鐺	쟈ᇰᄌᆞ	ᄐᆡᇰ
銚	쥬젼ᄌᆞ	됴
壺	호벼ᇰ	호
甁	벼ᇱ	벼ᇰ
勺	구기	쟉
斝	잔	가
壜	하ᇰ아리	담
罐	단디	관
盆	딜도ᇰᄒᆡ	분
盎	딜도ᇰᄒᆡ	아ᇰ
篘	로ᇰᄉᆞ	추
帘	주머니	렴
槽	고조	조
榨	고조	자
巵	대야	치
匜	귀대야	이
甌	보ᅀᆞ	구
盞	잔	잔
甖	대하ᇰ	여ᇰ
缸	하ᇰ	하ᇰ
瓮	독	오ᇰ
𤭛	독	가ᇰ
杯	잔	ᄇᆡ
鍾	죠ᇰ	죠ᇰ
觥	가탁	괴ᇰ
觴	잔	샤ᇰ
籃	ᄃᆞ라치	람
簍	두ᇰ주리	루
筥	광조리	게
筐	과ᇰ조리	과ᇰ
笊	죠ᄅᆡ	조
籬	죠ᄅᆡ	리[2]
𥬯	고리	고
䇭	고리	로
篋	섥	협
笥	섥	ᄉᆞ
籠	로ᇰ	로ᇰ
箱	샤ᇰᄌᆞᆺ	샤ᇰ
傘	우산	산
蓋	갯	개
屛	편푸ᇰ	벼ᇰ
扆	편푸ᇰ	의
袋	쟈ᄅᆞ	ᄃᆡ
帍	ᄒᆡᇰᄌᆞ쵸마	호
囊	ᄂᆞᄆᆞᆺ	나ᇰ
橐	주머니	탁
帳	댜ᇱ	댜ᇰ
㡡	댜ᇰ	듀
幃	댜ᇰ	위
幔	댜ᇰ	만
帷	댜ᇰ	유
幌	댜ᇰ	화ᇰ
幄	쟈ᅀᅵᆯ	악
幕	쟈ᅀᅵᆯ	막
𥮕	홰	하ᇰ
架	실에	가
楎	걸말	휘
椸	홰	이
幢	버ᇇ	다ᇰ
旛	버ᇇ	번
簾	발	렴
箔	발	박
鏡	거우로	겨ᇰ
鑑	거우로	감
奩	집	렴
匣	집	갑
鑽	비븨	찬
鑷	죡졉개	녑
錐	솔옷	쵸
觿	쇠약	휴
鍼	바ᄂᆞᆯ	침
熨	다리우리	울
剪	ᄀᆞᅀᅢ	젼
尺	자	쳑
刷	솨ᄌᆞ	솨
櫛	얼에빗	즐
梳	얼에빗	소
篦	ᄎᆞᆷ빗	비
繩	노	스ᇰ
索	노	삭
紘	벼리	괴ᇰ
綱	벼리	가ᇰ
板	널	판
漆	오칠	칠
礬	ᄇᆡᆨ버ᇇ	번
黐	감타ᇰ	치
桎	두드레	딜
梏	두드레	곡
枷	길	가
杻	두드레	류
釱	죡솨	태[3]
鋜	죡솨	착
鐐	죡솨	료
笞	ᄐᆡᆺ	ᄐᆡ
燈	현블	드ᇰ
燭	쵸	쵹
檠	드ᇰ겨ᇱ	겨ᇰ
篝	쵸로ᇰ	구
煤	돌숫	ᄆᆡ
炭	숫	탄
炬	홰	거
爐	화롯	로
蔉	누역	사
笠	갇	립
篊	홈	호ᇰ
筧	홈	현
桔	믈자ᅀᅢ	길
橰	믈자ᅀᅢ	고
轆	믈자ᅀᅢ	록
轤	믈자ᅀᅢ	로
椹	버터ᇰ	심
櫍	버터ᇰ	질
扇	부체	션
箑	부체	삽
鈹	돗바ᄂᆞᆯ	피
鉤	낛	구
䥷	쟉도	찰
鑹	담하	찬[4]
鎌	낟	렴
釤	낟	삼
鍥	낟	결
銍	낟	딜
鑢	줄	려
鐋	비타ᇰ	타ᇰ
銼	줄	차
鏟	거훔한	산
鉗	집게	겸
鎚	쇠마치	퇴
坩	도관	감
堝	도관	과
鎖	ᄌᆞᄆᆞᆯ쇠	쇠
鍉	열쇠	시
鍵	쇳속	건
鑰	열쇠	약
鉋	글게	포
䈜	먹갈	침
枵	ᄒᆞᆰ손	오
鏝	쇠손	만
錛	하ᇰ괴	분
鋸	톱	거
斧	도ᄎᆡ	부
鑿	ᄢᅳᆯ	착
鋤	호ᄆᆡ	서
钁	호ᄆᆡ	확
鎡	호ᄆᆡ	ᄌᆞ
錤	호ᄆᆡ	긔
鐃	요려ᇰ	요[5]
鈸	바라	발
鈴	바ᇰ올	려ᇰ
鐸	요려ᇰ	탁
網	그믈	마ᇰ
罟	그믈	고
罾	그믈	즈ᇰ
罝	그들	져
簄	토ᇰ발	호
罶	토ᇰ발	류
笱	토ᇰ발	구
籗	토ᇰ발	곽
耒	ᄯᅡ보	ᄅᆡ
耜	ᄯᅡ보	ᄉᆞ
鏵	볃	화
犂	보	례
彈	ᄩᆞᆯ	탄
矰	주살	즈ᇰ
弋	주살	익
繳	주살	쟉
鍫	삷	쵸
鍤	삷	삽
杷	서흐레	파
杴	가래	흠
耞	도리채	가
耬	익	루
磟	번디	록
碡	번디	독
綜	이ᇰ아	조ᇰ
緯	ᄂᆞᆯ	위
機	틀	긔
滕	도토마리	스ᇰ
帵	허ᇰ것	완
繃	최	브ᇰ
匹	ᄒᆞᆫ필	필
幅	ᄒᆞᆫ복	복
筟	북	부
梭	북	사
簆	ᄇᆞᄃᆡ	구
筬	ᄇᆞᄃᆡ	셔ᇰ
榬	어르	원
@	어르	약
杼	북	뎌
柚	ᄆᆞᆯ숩	튝
篲	뷔	슈
箒	뷔	츄
刀	갈	도
鞘	가플	쇼
瓦	디새	와
甎	벽	젼
瓴	벽	려ᇰ
甓	벽	벽
棍	막대	곤
棒	막대	바ᇰ
椎	마치	퇴
楔	쇠야기	셜
樁	말	좌ᇰ
橛	말	궐
椓	말	탁
杙	말	익
筲	토ᇰ	쇼
桶	토ᇰ	토ᇰ
綆	드레줄	겨ᇰ
繘	드레줄	휼
瓷	ᄎᆞ긔	ᄌᆞ
缶	딜	부
坯	ᄂᆞᆯ디새	ᄇᆡ
墼	ᄒᆞᆰ벽	격
@	밥쥭	쵸
杓	나므쥭	쟉
瓢	박	표
盠	박	례
棊	바독	긔
弈	쟈ᇰ긔	혁
骰	쇄ᅀᆞ	투
枰	판	펴ᇰ
丈	댜ᇱ	댜ᇰ
枴	갈고ᇰ막대	괘
笻	막대	고ᇰ
杖	막대	댜ᇰ
碫	ᄡᅮᆺ돌	단
礪	ᄡᅮᆺ돌	례
砥	ᄡᅮᆺ돌	지
硎	ᄡᅮᆺ돌	혀ᇰ
鞦	글위	츄
韆	글위	쳔
毬	댱바ᇰ올	구
@	뎌기	견
盂	다야	우
鉢	바리	발
塔	탑	탑
龕	자ᇰ	함
@	오ᄒᆡ야ᇰ	구
櫪	구ᅀᅵ	력
枊	ᄆᆞᆯ말	아ᇰ
@	ᄆᆞᆯ메	도
蕢	산태	궤
@	산태	본
篚	과ᇰ조리	비
函	함	함
飯	밥	반
食	밥	식
饔	밥	오ᇰ
飱	믈ᄆᆞᆫ 밥	손
餚	안쥬	효
饌	반찬	찬
饍	반찬	션
饈	차반	슈
餛	만두	혼
飩	만두	둔
餕	ᄯᅥᆨ소	산
饀	ᄯᅥᆨ소	함
餺	나화	박
飥	나화	탁
饅	사ᇰ화	만
@	사ᇰ화	투
餠	ᄯᅥᆨ	벼ᇰ
餌	ᄯᅥᆨ	ᅀᅵ
餈	ᄎᆞᄯᅥᆨ	ᄌᆞ
餻	ᄯᅥᆨ	고
糜	쥭	미
粥	쥭	쥭
饘	쥭	젼
漿	다ᇰ쉬	쟈ᇰ
糙	조미	조
糲	조미	랄
米	ᄡᆞᆯ	미
粒	ᄡᆞᆯ	립
麨	미시	쵸
糗	미시	구
糇	미시	후
粮	랴ᇰ식	랴ᇰ
醋	초	초
醯	초	혜
醢	젓	ᄒᆡ
鮓	젓	자
膾	횟	회
炙	젹	젹
羹	ᄀᆡᇰ	ᄀᆡᇱ
湯	타ᇰ	타ᇰ
虀	ᄎᆡ	졔
豉	젼국	시
油	기름	유
醬	쟈ᇰ	쟈ᇰ
@	차슈	산
餳	엿	셔ᇰ
飴	엿	이
糖	엿	다ᇰ
酒	술	쥬
醴	ᄃᆞᆫ술	례
醱	젼술	발
醅	젼술	ᄇᆡ
醪	탁쥬	료
酶	술믿	ᄆᆡ
酵	서김	교
麴	누룩	국
湩	타락	도ᇰ
酪	타락	락
酥	타락	소
蜜	ᄭᅮᆯ	밀
@	ᄆᆞᄅᆞᆫ 조긔	샤ᇰ
脯	보육	포
腊	보육	석
肉	고기	ᅀᅲᆨ
鹻	적	겸
鹺	소곰	자
鹽	소곰	염
滷	ᄀᆞᆫ슈	로
@	비지	자
@	딤ᄎᆡ	조
糝	쥭심	참
@	고기타ᇰ	확
麵	ᄀᆞᄅᆞ	면
麩	기울	부
@	ᄀᆞᄅᆞ	말
@	ᄀᆞᄅᆞ	셜
茶	차	다
茗	차	며ᇰ
糟	쥐여미	조
粕	쥐여미	박
冠	곳갈	관
冕	곳걸	면
幞	복도	복
弁	복도	변
巾	곳갈	건
帽	갇	모
@	곳갈	개
幘	곳갈	젹
袍	관ᄃᆡ옷	포
裘	갓옷	구
衫	젹삼	삼
裳	츄마	샤ᇰ
靴	훳	화
鞋	신	혜
履	신	리
舃	신	셕
裙	츄미	군
襉	주룸	간
裩	고의	군
袴	고의	고
@	보션	말
@	운혜	오ᇰ
襞	주룸	벽
襀	주룸	젹
袪	ᄉᆞ매	거
袂	ᄉᆞ매	몌
䘸	ᄉᆞ매	ᄋᆡᆨ
袖	ᄉᆞ매	슈
@	깃바대	탁
襠	고의 믿	다ᇰ
楎	ᄀᆞᄆᆞᆺ	훤
屐	격지	극
帕	슈건	파
帨	슈건	셰
衾	니블	금
被	니블	피
紳	ᄯᅴ	신
帶	ᄯᅴ	ᄃᆡ
銙	ᄯᅴᆺ돈	과
鞓	바타ᇰ	뎌ᇰ
笏	홀	홀
佩	노리개	패
@	셰툣	툐
繸	수ᅀᆞ	슈
紐	수ᄃᆞᆯ마기	뉴
@	암ᄃᆞᆯ마기	구
緌	긴	ᅀᅲ
纓	긴	여ᇰ
袈	가사	가
裟	가삿	사
衲	눕더기	납
襖	옷	오
襁	보로기	가ᇰ
褓	보로기	보
褯	깃	쟈
@	보로기	브ᇰ
領	옷깃	려ᇰ
襋	옷깃	극
襟	옷깃	금
袵	기슭	ᅀᅵᆷ
裌	겹옷	협
禪	호읫옷	단
縕	ᄂᆞᆯ근 소옴	온
襺	핟옷	견
絲	실	ᄉᆞ
線	실	션
縷	뵛오리	루
纑	뵛오리	로
纊	소옴	과ᇰ
絮	소옴	셔
緜	소옴	면
繭	고티	견
簪	빈혀	ᄌᆞᆷ
笄	빈혀	계
鎞	도ᇰ곳	비
𨥁	도ᇰ곳	차
珥	귀엿골회	ᅀᅵ
璫	귀엿골회	다ᇰ
釧	ᄑᆞᆯ쇠	쳔
環	골회	환
脂	기름	지
膏	곱	고
@	연지	연
@	연짓	지
髲	ᄃᆞᆯ외	피
髢	ᄃᆞᆯ외	톄
髻	샤ᇰ투	계
鬟	머리	환
舟	ᄇᆡ	쥬
船	ᄇᆡ	션
艇	ᄇᆡ	뎌ᇰ
艘	ᄇᆡ	수
帆	ᄇᆡᆺ돗	범
篷	ᄇᆡᆺ돗	보ᇰ
桅	ᄇᆡᆺ대	위
檣	ᄇᆡᆺ대	쟈ᇰ
纜	닫줄	람
碇	닫	뎌ᇰ
艣	놋	노
舵	밋	타
@	ᄠᅦ	패
筏	ᄠᅦ	벌
舫	ᄇᆡᄃᆞ리	바ᇰ
航	ᄇᆡᄃᆞ리	하ᇰ
篙	사횟대	고
戽	ᄑᆞ개	호
舥	ᄆᆡ	파
舠	ᄇᆡ	도
@	ᄇᆡᆺ	ᅀᅭ
楫	ᄇᆡᆺ	즙
棹	ᄇᆡᆺ	도
槳	ᄇᆡᆺ	쟈ᇰ
舷	ᄇᆡᆺ시울	현
艄	ᄇᆡᆺ 고ᄆᆞᆯ	쵸
舳	ᄇᆡᆺ고ᄆᆞᆯ	튝
艫	ᄇᆡᆺ니ᄆᆞᆯ	로
艦	ᄇᆡ	함
舶	ᄇᆡ	ᄇᆡᆨ
艚	ᄇᆡ	조
艑	ᄇᆡ	편
車	술위	거
輛	술위	랴ᇰ
輜	술위	츼
輧	술위	벼ᇰ
轎	교ᄌᆞᆺ	교
輿	술위	여
輅	술위	로
輦	술위	련
轓	술윗 란간	번
轅	ᄂᆞᄅᆞᆺ	원
軛	ᄂᆞᄅᆞᆺ 머리	ᄋᆡᆨ
輈	ᄂᆞ랏 머리	듀
輨	갈모	관
轄	쇠야기	할
軸	토ᇰ	튝
轂	토ᇰ	곡
軺	ᄃᆞᆯ고지	요
@	밀술위	가ᇰ
輪	바회	륜
輔	도을	보
輞	바회	마ᇰ
@	바회	거
轑	살	료
輻	살	복
鞍	기르마	안
鞽	가지	교
@	연좌ᅀᆞ	뎜
珂	ᄉᆞᆲ핌	가
韂	ᄃᆞᆯ애	쳠
靾	어치	톄
@	고ᄃᆞᆯ개	츄
@	졈불	쟈ᇰ
鞚	굴에	고ᇰ
勒	굴에	륵
鞿	굴에	긔
@	굴에	로ᇰ
轡	셕	비
靶	셕	파
靮	쥬리울	뎍
韁	쥬리울	가ᇰ
銜	마함	함
鑣	마함	표
鐙	드ᇰᄌᆞᆺ	드ᇰ
@	드ᇰ피	졀
鞭	채	편
檛	채	좌
@	채	?
策	채	ᄎᆡᆨ
干	바ᇰ패	간
櫓	바ᇰ패	로
盾	바ᇰ패	슌
瞂	바ᇰ패	벌
戈	차ᇰ	과
矛	차ᇰ	모
劒	환도	검
戟	차ᇰ	극
槍	차ᇰ	차ᇰ
槊	긴차ᇰ	삭
鋒	ᄂᆞᆯ	보ᇰ
鍔	ᄂᆞᆯ	악
@	갑	합
鋏	환도	협
鉞	도ᄎᆡ	월
鏚	도ᄎᆡ	쳑
銃	호토ᇰ	츄ᇰ
砲	셕탄ᄌᆞ	포
鼓	붑	고
鼙	붑	비
甲	갑	갑
鎧	갑	개
冑	투구	듀
鍪	투구	모
弓	활	구ᇰ
弧	활	호
弩	소니	노
弦	시울	현
弰	활고재	쇼
弭	고재	미
弝	좀	파
彄	활오ᄂᆡ	구
@	헐겁지	결
韘	헐겁지	셥
@	ᄑᆞᆯ지	한
韝	ᄑᆞᆯ지	구
@	솔관	져ᇰ
@	솔관	뎍
堋	무겁	브ᇰ
帿	솔	후
翎	살짓	려ᇰ
@	고도리	박
髇	울고도리	호
骲	ᄲᅧ고도리	박
鏃	살믿	족
鏑	살믿	뎍
鈚	히ᇰ?그럭	피
鍭	살믿	후
箭	살	젼
矢	살	시
筈	살오ᄂᆡ	괄
笴	삸대	간
鉦	ᄌᆡᇰ	져ᇰ
鑼	ᄌᆡᇰ	라
旗	긧	긔
纛	둑	독
@	구ᇰᄃᆡ	?
鞬	구ᇰᄃᆡ	건
韣	구ᇰᄃᆡ	독
韔	구ᇰᄃᆡ	탸ᇰ
@	도ᇰ개	보
靫	도ᇰ개	차
箶	도ᇰ개	호
簏	도ᇰ개	록
堊	ᄒᆡᆫᄒᆞᆰ	악
素	ᄒᆡᆯ	소
粉	부ᇇ	분
白	ᄒᆡᆫ	ᄇᆡᆨ
@	쳐ᇰᄃᆡ	뎐
靑	프를	쳐ᇰ
黛	쳐ᇰᄃᆡᆺ	ᄃᆡ
黑	거믈	흑
玄	가ᄆᆞᆯ	현
皂	거믈	조
丹	블글	단
雘	블글	확
彤	블글	도ᇰ
赭	블글	쟈
赬	블글	뎌ᇰ
赤	블글	젹
朱	블글	쥬
緋	블글	ᄇᆡ
紅	블글	호ᇰ
絳	블글	가ᇰ
黃	누를	화ᇰ
紫	ᄌᆞ딛	ᄌᆞ
綠	프를	록
碧	ᄑᆞᄅᆞᆯ	벽
紗	삿	사
羅	놋	라
綾	고로	르ᇰ
段	비다ᇇ	단
鎌	깁	겸
絁	모시뵈	시
布	뵈	포
帛	비단	ᄇᆡᆨ
氁	무ᄌᆞ	모
@	무ᄌᆞ	갈
@	시욱	젼
毯	다ᇝ	담
綈	굴근 깁	뎨
繒	ᄀᆞᄂᆞᆫ 깁	즈ᇰ
絺	ᄀᆞᄂᆞᆫ 뵈	티
綌	굴근 뵈	격
紈	깁	환
綺	깁	긔
綃	깁	쵸
絹	깁	견
錦	그ᇝ	금
紬	며ᇰ디	듀
縐	무뤼	추
縠	무뤼	곡
寶	보ᄇᆡᆺ	보
貝	쟈개	패
錢	돈	젼
鈔	춋	쵸
金	쇠	금
銀	은	은
珠	구슬	쥬
玉	옥	옥
銅	구리	도ᇰ
鐵	쇠	텰
鍮	듀셕	듀
鉐	듀셕	셕
汞	슈은	호ᇰ
鈆	연	연
鑞	납	랍
錫	납	셕
瓊	구슬	겨ᇰ
瑤	구슬	요
瓔	구슬	여ᇰ
珞	구슬	락
珍	구슬	딘
玭	진쥬	변
璣	구슬	긔
璧	구슬	벽
珊	산홋	산
瑚	산홋	호
瑪	마놋	마
瑙	마놋	노
琉	류릿	류
璃	류릿	리
琥	호박	호
珀	호박	ᄇᆡᆨ
琵	비홧	비
琶	비홧	파
鐘	쇠붑	죠ᇰ
磬	셕겨ᇱ	경
琴	고	금
瑟	비화	슬
笳	초덕	가
拍	ᄇᆡᆨ	ᄇᆡᆨ
笙	ᄉᆡᇱ	ᄉᆡᇰ
簫	숏	쇼
管	뎌	관
籥	뎌	약
觱	피리	필
篥	피리	률
箏	아ᄌᆡᇰ	ᄌᆡᇰ
笛	뎌	뎍
疾	병ᄒᆞᆯ	질
病	벼ᇱ	벼ᇰ
疼	알ᄑᆞᆯ	도ᇰ
痛	알ᄑᆞᆯ	토ᇰ
吐	토ᄒᆞᆯ	토
瀉	즈칄	샤
嘔	개올	구
@	개올	역
疲	시드러울	피
憊	여윌	븨
憔	셔ᇰ가실	쵸
悴	셔ᇰ가실
羸	여윌	리
瘦	여윌	수
癯	여윌	구
瘠	어윌	쳑
癬	버즘	션
癜	어루러지	뎐
疥	옴	개
癩	료ᇰ벼ᇰ	뢰
疱	ᄣᅳ리	포
痘	ᄒᆡᇰ역	두
瘰	련쥬차ᇰ	라
癧	련쥬차ᇰ	력
蠱	좀	고
脹	탸ᇰ만	탸ᇰ
疔	뎌ᇰ죠ᇰ	뎌ᇰ
疸	화ᇰ닰	단
喘	쳔만	쳔
咳	기츰	ᄒᆡ
嗽	기츰	수
癮	두드러기	은
@	두드러기	딘
癤	브ᅀᅳ름	졀
疿	ᄯᆞᆷ되어야기	블
疣	혹	우
贅	혹	ᄎᆒ
癭	믈혹	여ᇰ
瘤	믈혹	류
跎	드ᇰ 구블	타
瘸	젉	가
瘖	버워리	암
瘂	버워리	아
㿗	퇴산	퇴
疝	퇴산	산
瘻	루차ᇰ	루
痔	디질	티
癎	겨ᇰ가ᇇ	간
痓	등 고ᄃᆞᆯ	딜
狂	미칠	과ᇰ
癲	미칠	뎐
疶	즈칄	셜
痢	즈칄	리
聤	귀 헐	뎌ᇰ
@	귀 헐	뎨
癰	브ᅀᅳ름	오ᇰ
疽	브ᅀᅳ름	져
瘡	헐므ᅀᅳᆯ	차ᇰ
趼	부루틀	견
痎	고곰	ᄒᆡ
瘧	고곰	학
痁	고곰	졈
癨	도와리	확
瘟	쟈ᇰ셕	온
疫	쟈ᇰ셕	역
痰	춤	담
瘚	손 발 ᄎᆞᆯ	궐
黶	사마괴	염
痣	사마괴	지
皸	ᄃᆞᆯ	군
瘃	ᄃᆞᆯ	탁
腫	부ᅀᅳᆯ	죵
脪	발셜	흔
痂	더데	가
@	더데	차
瘢	허믈	반
痕	허믈	흔
疤	허믈	파
疵	허믈	ᄌᆞ
崩	믈허딜	브ᇰ
薨	주글	후ᇰ
@	주글	졸
死	주글	ᄉᆞ
魂	넉	혼
魄	넋	ᄇᆡᆨ
輀	술위	ᅀᅵ
櫬	안집	친
棺	안집	관
柩	곽	구
槨	밧집	곽
殮	갈믈	렴
屍	주검	시
殯	비ᇰ솟	빈
葬	무들	자ᇰ
窀	무덤	둔
穸	무덤	셕
碑	빗	비
碣	갈셕	갈
墳	무덤	분
塚	무덤	툐ᇰ
墓	무덤	묘
壙	구모	과ᇰ
混	흐릴	혼
沌	얼읠	돈
開	열	ᄀᆡ
闢	열	벽
淸	ᄆᆞᆯᄀᆞᆯ	쳐ᇰ
濁	흐릴	탁
位	벼슬	위
奠	노ᄒᆞᆯ	뎐
造	지ᅀᅳᆯ	조
化	도읠	화
斡	두를	알
旋	두를	션
光	빗	과ᇰ
景	볃	겨ᇰ
流	흐를	류
轉	올믈	뎐
旻	하ᄂᆞᆯ	민
昊	하ᄂᆞᆯ	호
穹	구븓ᄒᆞᆯ	구ᇰ
窿	구븓ᄒᆞᆯ	류ᇰ
暾	ᄒᆡᆺ귀	돈
旭	ᄒᆡᆺ귀	욱
暈	모로	운
明	ᄇᆞᆯᄀᆞᆯ	명
照	ᄇᆞᅀᆡᆯ	죠
曜	ᄇᆞᅀᆡᆯ	요
暉	비췰	휘
暎	ᄇᆞᅀᆡᆯ	여ᇰ
暪	아ᄃᆞᆨᄒᆞᆯ	만
眛	아ᄃᆞᆨᄒᆞᆯ	ᄆᆡ
暗	아ᄃᆞᆨᄒᆞᆯ	암
暝	아ᄃᆞᆨᄒᆞᆯ	며ᇰ
暄	더울	훤
暖	더울	난
炎	더울	염
燠	더울	욱
凉	ᄎᆞᆯ	랴ᇰ
冷	ᄎᆞᆯ	ᄅᆡᇰ
凍	얼	도ᇰ
冸	노글	반
晴	갤	쳐ᇰ
霽	갤	졔
霾	ᄒᆞᆰ비	ᄆᆡ
曀	흐릴	예
昕	아ᄎᆞᆷ	흔
晡	나죄	포
昃	기울	ᄎᆡᆨ
旰	느즐	한
古	녜	고
今	엳	금
翌	ᄂᆡ일	익
昨	어제	작
夙	이를	슉
晏	느즐	안
曩	아ᄅᆡ	나ᇰ
昔	녜	셕
人	사ᄅᆞᆷ	ᅀᅵᆫ
物	갓	믈
受	바ᄃᆞᆯ	슈
賦	ᄐᆡ올	부
品	ᄎᆞ례	품
彙	물	휘
滋	부를	ᄌᆞ
殖	부를	식
羽	짓	우
毛	터럭	모
鱗	비늘	린
介	다ᇰ아리	개
飛	ᄂᆞᆯ	비
潛	ᄌᆞᆷᄀᆞᆯ	ᄌᆞᆷ
動	뮐	도ᇰ
植	시믈	식
@	벌에	곤
蟲	벌에	튜ᇰ
禽	새	금
鳥	새	됴
魚	고기	어
獸	즘ᄉᆡᇰ	슈
禾	쉬	화
穀	낟	곡
菓	여름	과
蓏	여름	라
菜	ᄂᆞᄆᆞᆯ	ᄎᆡ
蔬	ᄂᆞᄆᆞᆯ	소
草	플	초
卉	플	훼
樹	나모	슈
木	나모	목
根	불휘	근
荄	불휘	ᄒᆡ
株	읏듬	듀
幹	읏듬	간
槎	들궐	사
@	그르	알
萌	움	ᄆᆡᇰ
芽	엄	아
柯	가지	가
枝	가짓	지
葉	닙	엽
花	곳	화
蘂	여희	예
英	곳부리	여ᇰ
葩	곳 보ᇰ리	파
叢	ᄠᅥᆯ기	초ᇰ
苞	ᄠᅥᆯ기	포
莖	줄기	ᄀᆡᇰ
蔕	고고리	톄
藤	너출	드ᇰ
虆	너출	류
秧	움	아ᇰ
苗	이삭	묘
榮	비ᅀᅳᆯ	여ᇰ
華	빗날	화
枯	이울	고
槁	이울	고
柴	섭	싀
薪	섭	신
蒭	ᄭᅩᆯ	추
蕘	섭나모	요
稈	줄기	간
稭	줄기	ᄀᆡ
穎	이삭	여ᇰ
穗	이삭	슈
梗	줄기	겨ᇰ
莿	가ᄉᆡ	ᄌᆞ
杈	거릴	차
梢	귿	쵸
耕	갈	겨ᇰ
耰	ᄡᅵ두플	우
種	시믈	죠ᇰ
蒔	옴겨 시믈	시
耘	기ᅀᅳᆷ ᄆᆡᆯ	운
耔	붓도돌	ᄌᆞ
@	기ᅀᅳᆷᄆᆡᆯ	표
薅	기ᅀᅳᆷᄆᆡᆯ	호
栽	시믈	ᄌᆡ
椄	졉ᄒᆞᆯ	졉
@	것고즐	쳔
揷	고즐	삽
培	붓도돌	ᄇᆡ
壅	붓도돌	오ᇰ
零	ᄠᅳᆮ드를	려ᇰ
落	딜	락
@	ᄧᅩᆨ	린
瓣	ᄧᅩᆨ	판
@	ᄡᅵ	다ᇰ
瓤	어월	야ᇰ
竿	댓줄기	간
箬	댓닙	ᅀᅣᆨ
筠	댓 겁질	균
籜	댓 고의	탁
稼	시믈	가
穡	거둘	ᄉᆡᆨ
@	누릴	라
@	누리	타
收	거둘	슈
割	버힐	할
刈	뷔	애
穫	뷜	확
擣	디흘	도
舂	디흘	쇼ᇰ
簸	가볼올	파
@	슬흘	벌
稃	거플	부
秕	주글	피
穅	겨	가ᇰ
麧	겨	흘
莩	ᄀᆞᆯ쳐ᇰ	부
莢	고토리	협
柎	곳고의	부
萼	곳고의	악
榾	불휫 들궐	골
柮	불휫 들궐	돌
核	ᄡᅵ	ᄒᆡᆨ
@	ᄡᅵ	골
肫	멀더건	둔
膍	멀더건	비
距	톱	거
尾	ᄭᅩ리	미
@	새 부리	ᄎᆌ
喙	부리	훼
嗉	산멱	소
吭	새 목	하ᇰ
翰	짓	한
翮	짓	격
翅	ᄂᆞᆯ개	시
翼	ᄂᆞᆯ개	익
翶	봄놀	고
翔	봄놀	샤ᇰ
@	ᄂᆞ라 오를	힐
@	ᄂᆞ라 ᄂᆞ릴	하ᇰ
雌	암	ᄌᆞ
雄	수	우ᇰ
牝	암	비ᇰ
牡	수	모
塒	깃	시
巢	깃	소
窠	깃	과
棲	기ᅀᅳᆯ	셔
孶	삿기 칠	ᄌᆞ
菢	알아늘	포
卵	알	란
雛	삿기	추
啄	딕머글	탁
哺	머길	포
鷇	삿기	구
啼	울	뎨
騲	암	초
騍	아ᄃᆞᆯ	과
牯	수쇼	고
牸	암	ᄌᆞ
犍	악대	건
犗	악대	계
騸	불아ᅀᆞᆯ	션
驐	불아ᅀᆞᆯ	돈
肥	ᄉᆞᆯ질	비
@	ᄉᆞᆯ질	표
@	고낼	사ᇰ
踠	ᄆᆞᆯ 거틸	완
羖	수야ᇰ	고
羝	수야ᇰ	뎨
羯	악대야ᇰ	갈
豶	악대돋	분
嘲	울	됴
@	울	야
@	울	셕
鳴	우룸	며ᇰ
嘶	울	싀
吠	즈즐	폐
噪	우지질	조
雊	울	구
蠢	구믈어릴	쥰
蠕	구믈어릴	ᅀᅧᆫ
翀	ᄂᆞ라 오ᄅᆞᆯ	튜ᇰ
翥	ᄂᆞᆯ	쟈
咆	우를	포
嘷	우를	호
呌	울	교
吼	우를	후
咂	믈	잡
囓	믈	혈
噬	믈	셔
咬	믈	교
觝	ᄣᅵ를	뎨
觸	ᄣᅵ를	쵹
踶	ᄎᆞᆯ	뎨
@	ᄎᆞᆯ	위
閑	멀험	한
圈	어리	권
苙	우리	립
棧	우리	잔
豢	칠	환
養	칠	야ᇰ
飼	머길	ᄉᆞ
餵	머길	위
騎	ᄐᆞᆯ	긔
乘	ᄐᆞᆯ	스ᇰ
駕	머ᇰ에	가
馭	ᄆᆞᆯ 달홀	어
@	내맛ᄆᆞᆯ	산
駷	셕다틸	소ᇰ
馳	ᄃᆞᆯ일	티
驅	몰	구
蒐	산ᄒᆡᇰ	수
狩	산ᄒᆡᇰ	슈
@	산ᄒᆡᇰ	션
畋	산ᄒᆡᇰ	뎐
釣	나ᄭᅳᆯ	됴
射	ᄡᅩᆯ	쌰
屠	주길	도
皮	갓	피
革	갓	혁
韋	갓	위
鞹	갓	곽
筋	힘	근
角	ᄲᅳᆯ	각
鬣	갈기	렵
鬉	갈기	조ᇰ
䰇	지네	기
鰾	부레	표
蹄	굽	뎨
蹢	굽	뎍
蟠	서릴	반
蟄	수믈	팁
蛻	허ᇰ울	예
@	허ᇰ울	고ᇰ
蚛	좀머글	듀ᇰ
蝕	벌에 머글	식
蘞	목 ᄡᅩᆯ	험
螫	벌 ᄡᅩᆯ	셕
@	잰ᄆᆞᆯ	찬
@	누읏굴	뎐
騰	봄놀	드ᇰ
驤	봄놀	야ᇰ
弨	활 브리울	툐
弛	활 브리울	이
@	도지게	겨ᇰ
@	대자비	튜
彀	활 혈	구
@	활 혈	곽
彎	활 혈	만
張	활 지흘	댜ᇰ
祭	졔ᄒᆞᆯ	졔
祀	졔ᄒᆞᆯ	ᄉᆞ
歆	자실	흠
饗	자실	힝
福	복	복
祿	녹	녹
祐	복	우
祚	복	조
宴	이바디	연
餞	젼소ᇰ	젼
犒	이바ᄃᆞᆯ	고
@	이바ᄃᆞᆯ	로
餫	이바ᄃᆞᆯ	운
餉	이바ᄃᆞᆯ	햐ᇰ
饁	이바ᄃᆞᆯ	녑
酺	이바ᄃᆞᆯ	포
汲	기를	급
注	브ᅀᅳᆯ	주
澡	시슬	조
洗	시슬	셰
沐	머리 ᄀᆞᄆᆞᆯ	목
浴	모욕	욕
漱	야ᇰ지ᄒᆞᆯ	수
盥	ᄂᆞᆺ 시슬	관
淘	일	도
淅	일	셕
沙	일	사
汰	일	태
泔	ᄯᅳ믈	감
潘	ᄯᅳ믈	번
瀋	ᄯᅳ믈	심
@	ᄯᅳ믈	간
笮	지즐울	ᄎᆡᆨ
壓	지즐울	압
澄	ᄆᆞᆯ길	드ᇰ
濾	ᄆᆞᆯ길	려
渣	즈ᅀᅴ	사
滓	즈ᅀᅴ	ᄌᆡ
垽	즈ᅀᅴ	은
澱	즈ᅀᅴ	뎐
涌	소ᄉᆞᆯ	요ᇰ
沸	글흘	비
滾	글흘	곤
涫	글흘	관
添	더을	텸
沃	ᄲᅳ릴	옥
溢	너믈	일
瀽	넘ᄯᅵᆯ	건
@	주길	지
殺	주길	살
@	튀ᄒᆞᆯ	퇴
燖	무더니길	심
撕	ᄧᅳ즐	ᄉᆞ
@	ᄠᅳ들	ᅀᅧᆷ
烝	ᄠᅵᆯ	즈ᇰ
缹	ᄠᅳᆯ	부
炊	밥 지ᅀᅳᆯ	ᄎᆔ
爨	블 디들	찬
烹	ᄉᆞᆯᄆᆞᆯ	ᄑᆡᇰ
煮	ᄉᆞᆯᄆᆞᆯ	쟈
@	밥 니글	ᅀᅵᆸ
熟	니글	슉
饙	아ᅀᅵ ᄠᅵᆯ	분
餾	ᄠᅴ울	류
攤	펼	탄
@	ᄆᆞᄅᆞᆯ	간
擂	ᄀᆞᆯ	뢰
硏	ᄀᆞᆯ	연
@	다ᄆᆞᆯ	ᄌᆡ
盛	다ᄆᆞᆯ	셔ᇰ
飣	괼	뎌ᇰ
餖	괼	두
醃	ᄀᆞᆫ저릴	엄
@	긔ᄒᆞᆯ	번
@	매ᄐᆞᆯ	ᄆᆡ
浥	달 ᄠᅳᆯ	읍
饐	쉴	에
餲	쉴	애
醭	골아지	복
殕	곰퓔	부
@	블 ᄧᅬᆯ	고
煏	블 ᄧᅬᆯ	핍
焙	블 ᄧᅬᆯ	ᄇᆡ
烘	블 ᄧᅬᆯ	호ᇰ
燔	구을	번
炙	구을	쟈
煠	데틸	잡
爚	데틸	약
爁	봇글	람
焦	누를	쵸
炮	구을	포
爊	고을	오
煎	지질	젼
熬	봇글	오
炒	봇글	쵸
煿	봇글	박
@	맛볼	샤ᇰ
嗜	즐길	기
饞	음식 탐ᄒᆞᆯ	참
渴	목 ᄆᆞᄅᆞᆯ	갈
味	맛	미
臭	내	ᄎᆔ
香	곳다올	햐ᇰ
馨	곳다올	혀ᇰ
葷	누릴	훈
釅	ᄆᆡ올	엄
醇	두터울	슌
醲	두터울	노ᇰ
腐	서글	부
臊	누릴	조
羶	노릴	젼
@	비릴	셔ᇰ
辛	ᄆᆡ올	신
辣	ᄆᆡ올	랄
酸	싈	산
苦	ᄡᅳᆯ	고
甘	ᄃᆞᆯ	감
甛	ᄃᆞᆯ	텸
鹹	ᄧᆞᆯ	함
淡	슴거울	담
呑	머구믈	ᄐᆞᆫ
含	머구믈	함
噙	씨블	금
@	ᄉᆞᆷᄭᅵᆯ	연
齦	너흘	근
齕	너흘	흘
喫	머글	긱
噉	머글	담
嗍	ᄲᆞᆯ	삭
吮	ᄲᆞᆯ	연
舐	할ᄒᆞᆯ	뎨
舔	할ᄒᆞᆯ	텸
啜	마실	텰
歃	마실	삽
飮	마실	음
嚼	십두드릴	쟉
醞	비즐	온
釀	비즐	야ᇰ
泲	바ᄐᆞᆯ	ᄌᆞ
@	바ᄐᆞᆯ	록
釃	거를	싀
@	브ᅀᅳᆯ	채
斟	브ᅀᅳᆯ	짐
酌	브ᅀᅳᆯ	쟉
@	ᄯᅳᆯ	규
挹	ᄯᅳᆯ	읍
@	ᄯᅳᆯ	요
抒	ᄯᅳᆯ	셔
獻	받ᄌᆞ올	헌
酬	가플	슈
交	섯글	교
錯	섯글	착
樂	음악	악
曲	놀애	곡
吹	불	츄
唱	브를	챠ᇰ
歌	놀애	가
舞	춤	무
醉	ᄎᆔᄒᆞᆯ	ᄎᆔ
酗	쥬져ᇰᄒᆞᆯ	후
耍	노ᄅᆞᆺ	솨
戱	노ᄅᆞᆺ	희
@	짓글힐	홍
@	짓글힐	뇨
罵	구지즐	마
詈	구지즐	리
戰	싸홈	젼
鬪	싸홈	투
@	ᄇᆡ목	굴
銊	ᄇᆡ목	슐
斿	긧발	유
旒	긧발	류
鋩	ᄂᆞᆯ	마ᇰ
刃	ᄂᆞᆯ	ᅀᅵᆫ
鉎	쇠보ᄆᆡᆯ	ᄉᆡᇰ
銹	쇠보ᄆᆡᆯ	슈
型	얼굴	혀ᇰ
模	얼굴	모
@	불뭇 골	패
@	허릿나모	례
鐏	마기	존
錔	마기	답
釰	이ᇇᄌᆞᄅᆞ	뉴
釦	젼메울	구
焇	노글	쇼
烊	노글	야ᇰ
焠	ᄃᆞᄆᆞᆯ	슈
鋥	ᄀᆞ다 ᄃᆞᄆᆞᆯ	뎌ᇰ
鎔	노길	요ᇰ
冶	불무	야
鍊	쇠 니길	련
鍛	쇠 니길	단
錭	사길	됴
鏤	사길	루
鍍	도금ᄒᆞᆯ	도
鋈	납ᅀᅧᆷᄒᆞᆯ	옥
鑄	담질ᄒᆞᆯ	주
@	노겨 브ᅀᅳᆯ	샤
錮	마글	고
銲	ᄯᅢᆯ	한
璺	금시를	문
瑕	기믜	하
綻	ᄯᅡ딜	탄
@	ᄠᅥ딜	분
釘	몯	뎌ᇰ
鉸	사복	교
蔑	대ᄧᅩᆨ	멸
箍	데메울	고
橫	빗글	회ᇰ
斜	빗글	샤
欹	기울	긔
歪	기울	괴
牮	니를	젼
拄	바퇼	듀
搘	괴올	지
捂	괴올	오
頹	믈어딜	퇴
圮	믈어딜	븨
@	믈어딜	단
塌	믈어딜	탑
甃	무ᅀᅳᆯ	츄
砌	무ᅀᅳᆯ	쳬
築	ᄉᆞᆯ	튝
壘	무ᅀᅳᆯ	류
傾	기울	겨ᇰ
仄	기울	측
撼	뮈울	함
揝	뮈울	잠
撑	괴올	ᄐᆡᇰ
@	괴올	뎜
@	괴올	삽
@	괴올	궤
坑	굳	ᄀᆡᇰ
坎	굳	감
坳	우묵ᄒᆞᆯ	요
陷	ᄢᅥ딜	함
磽	마ᄆᆞᄅᆞᆯ	교
@	마ᄆᆞᄅᆞᆯ	각
塉	마ᄆᆞᄅᆞᆯ	쳑
潟	ᄧᆞᆯ	셕
溜	기슭믈	류
冓	외촘	구
基	터	긔
址	터	지
@	디새닐	와
苫	새닐	셤
稕	바조	쥰
@	랴ᇰ테	격
孔	구무	고ᇰ
穴	구무	혈
窟	구무	굴
@	구무	롱
罅	ᄭᅳᆷ	하
釁	ᄭᅳᆷ	흔
阿	ᄭᅳᆷ	아
隙	ᄭᅳᆷ	극
塵	듣글	딘
埃	듣글	애
坌	듣글	분
塕	듣글	오ᇰ
垢	ᄠᆡ	구
圿	ᄠᆡ	갈
塊	ᄒᆞᆰ무적	괴
堛	ᄒᆞᆰ무적	벽
居	살	거
處	살	쳐
器	그릇	긔
皿	그릇	며ᇰ
衣	옷	의
服	옷	복
財	ᄌᆡ홧	ᄌᆡ
貨	ᄌᆡ홧	화
豊	녀름 됴ᄒᆞᆯ	푸ᇰ
稔	니글	님
飽	ᄇᆡ브를	포
飫	ᄇᆡ브를	어
歉	험년	겸
儉	험년	검
餒	주릴	뇌
餓	주릴	아
繅	실혈	소
繹	실혈	역
紡	사믈	바ᇰ
絡	ᄂᆞ릴	락
緝	삼 사ᄆᆞᆯ	즙
績	삼 사ᄆᆞᆯ	젹
@	뵈ᄂᆞᆯ	ᅀᅵᆷ
織	ᄧᆞᆯ	직
紺	블글	감
緅	블글	츄
纁	블글	훈
緗	노ᄂᆞᆯ	샤ᇰ
裁	ᄆᆞᄅᆞᆯ	ᄌᆡ
縫	홀	보ᇰ
繡	슈질	슈
刺	치질	쳑
穿	ᄃᆞᆯ올	쳔
着	니블	탹
摳	거두들	구
攐	거두들	건
裸	바ᄉᆞᆯ	라
裎	바ᄉᆞᆯ	뎌ᇰ
袒	메와ᄉᆞᆯ	탄
裼	바ᄉᆞᆯ	텩
套	ᄭᅵᆯ	토
搭	걸틸	탑
鞁	기르마 지홀	피
鞔	붑 메울	만
裝	ᄭᅮ밀	자ᇰ
@	ᄉᆞ견	ᄉᆞ
嵌	ᄢᅵ울	감
塑	ᄒᆞᆰ 비즐	소
粧	ᄭᅮ밀	자ᇰ
扮	비ᅀᅳᆯ	반
搽	ᄇᆞᄅᆞᆯ	차
抹	스슬	말
褪	버ᇰ글	돈
卸	브리울	샤
襤	옷 헐	람
褸	옷 헐	루
圖	그림	도
寫	쓸	쌰
描	그릴	묘
罨	그릴	압
紋	어르누글	문
綵	빗날	ᄎᆡ
繪	그림	회
飾	ᄭᅮ밀	식
誆	소길	과ᇰ
賺	소길	담
騙	소겨 아ᄋᆞᆯ	편
拐	건디쥘	괘
博	밧골	박
換	밧골	환
糶	ᄡᆞᆯ ᄑᆞᆯ	됴
糴	ᄡᆞᆯ 살	뎍
租	고ᇰ셰	조
稅	고ᇰ솃	셰
貢	바틸	고ᇰ
納	드릴	납
徵	물일	디ᇰ
斂	거둘	렴
課	혤	과
式	얼굴	식
售	발뵐	슈
衒	ᄑᆞᆯ	현
賣	ᄑᆞᆯ	매
鬻	ᄑᆞᆯ	육
沽	살	고
買	살	ᄆᆡ
購	살	구
貿	살	무
賖	왼빋	샤
貰	왼빋	셰
販	도의	판
贗	거즛	안
貼	팀바ᄃᆞᆯ	텹
@	민갑드릴	렴
賃	셰물	님
僦	셰물	ᄎᆔ
賄	쳔랴ᇰ줄	회
賂	쳔랴ᇰ줄	뢰
贈	줄	즈ᇰ
貽	줄	이
賞	샤ᇰ급	샤ᇰ
賜	줄	ᄉᆞ
給	줄	급
賚	줄	뢰
贖	물일	쇽
債	빋	채
陪	물일	ᄇᆡ
償	가플	샤ᇰ
乞	빌	걸
假	빌	가
借	빌	챠
貸	ᄢᅱ일	ᄃᆡ
籤	사ᄉᆞᆯ	쳠
籌	사ᄉᆞᆯ	듀
占	졈복	졈
筮	졈복	셔
摴	ᅀᅲᆺ	뎌
蒱	포
賭	나기ᄒᆞᆯ	도
賽	싯굴	ᄉᆡ
擹	ᅀᅲᆺ놀	탄
擲	더딜	텩
拈	자ᄇᆞᆯ	졈
@	ᄡᅪᇰ불 쥘	구
輸	옴길	슈
贏	ᄀᆞᄃᆞᆨᄒᆞᆯ	여ᇰ
勝	이긜	스ᇰ
敗	ᄒᆡ야딜	패
搔	글글	소
爬	글글	파
㧓	긁쥘	과
搯	뎌길	겹
@	우흴	와
捧	우훔	보ᇰ
抔	우흴	부
掬	우흴	국
搜	더드믈	수
探	더드믈	탐
括	거둘	괄
檢	검찰ᄒᆞᆯ	검
蘸	ᄌᆞᄆᆞ디를	잠
杻	뷔틀	뉴
撈	건딜	로
漉	건딜	록
攬	후리ᄡᅳᆯ	람
攬	후리ᄡᅳᆯ	루
捗	거두ᄡᅳᆯ	보
攎	거두ᄡᅳᆯ	로
抖	ᄠᅥᆯ	두
擻	ᄠᅥᆯ	수
搓	뷜	차
挪	뷜	나
捻	뱌ᄇᆡᆯ	녑
揑	뱌ᄇᆡᆯ	녈
撚	뱌ᄇᆡᆯ	년
搣	뱌ᄇᆡᆯ	멸
@	ᄲᅮ븰	번
撋	ᄲᅮ븰	ᅀᅧᆫ
捼	ᄲᅮ븰	나
挱	ᄲᅮ븰	사
擡	들	ᄃᆡ
扛	멜	가ᇰ
擔	멜	담
@	멜	햐ᇰ
拂	ᄡᅳᆯ	불
拭	ᄡᅳᆯ	식
搵	쓰슬	온
揩	쓰슬	ᄀᆡ
負	질	부
戴	일	ᄃᆡ
馱	시를	타
載	시를	ᄌᆡ
擠	밀와들	졔
拶	ᄎᆡᆨᄎᆡᆨᄒᆞᆯ	찰
排	버릴	ᄇᆡ
挨	미질	애
吾	나	오
我	나	아
予	나	여
俺	나	암
咱	나	자
自	스스로	ᄌᆞ
他	뎌	타
彼	뎌	피
誰	뉘	슈
孰	뉘	슉
伊	저	이
某	아못	모
你	너	니
恁	너	님
汝	너	ᅀᅧ
爾	너	ᅀᅵ
儕	벋	졔
@	물	ᄇᆡ
廝	브릴	싀
每	물	ᄆᆡ
寃	셜울	원
讎	원슛	슈
仇	원슈	구
敵	ᄀᆞᆯ올	뎍
偸	도ᄌᆞᆨᄒᆞᆯ	투
竊	일워ᅀᆞᆯ	졀
攘	아ᅀᆞᆯ	ᅀᅣᆼ
奪	아ᅀᆞᆯ	탈
搶	후릴	차ᇰ
掠	후릴	략
俘	사ᄅᆞ자ᄇᆞᆯ	부
馘	귀 버힐	괵
聖	셔ᇰᅀᅵᆫ	셔ᇰ
賢	어딜	현
廉	쳐ᇰ렴	렴
哲	ᄉᆞᄆᆞᆺ 알	텰
豪	어딜	호
傑	ᄌᆡ조 노ᄑᆞᆯ	걸
俊	어딜	쥰
乂	다ᄉᆞᆯ	예
仁	클	ᅀᅵᆫ
慈	ᄌᆞ비로읠	ᄌᆞ
信	미들	신
義	마ᄌᆞᆯ	의
忠	튜ᇰ뎌ᇰ	튜ᇰ
恕	ᄆᆞᅀᆞᆷ	져
孝	효도	효
悌	아ᅀᆞ로읠	뎨
誠	졍셔ᇱ	셔ᇰ
敬	고ᇰ겨ᇱ	겨ᇰ
貞	고ᄃᆞᆫ	뎌ᇰ
烈	ᄆᆡ올	렬
恭	온고ᇱ	고ᇰ
讓	ᄉᆞ야ᇰ	ᅀᅣᆼ
謹	삼갈	근
慧	여ᇰ노ᄒᆞᆯ	혜
剛	구들	가ᇰ
悍	욷거울	한
勇	ᄂᆞᆯ날	요ᇰ
智	디혯	디
强	힘셀	가ᇰ
猛	ᄆᆡ올	ᄆᆡᇰ
暴	모딜	포
武	ᄆᆡ올	무
尊	존ᄒᆞᆯ	존
卑	ᄂᆞᆺ가올	비
貴	귀ᄒᆞᆯ	귀
賤	쳔ᄒᆞᆯ	쳔
壽	목숨	슈
夭	주글	요
貧	가난ᄒᆞᆯ	빈
富	가ᅀᆞ멸	부
姿	야ᇰᄌᆞᆺ	ᄌᆞ
態	야ᇰᄌᆞᆺ	ᄐᆡ
蹤	자최	죠ᇰ
跡	자최	젹
進	나ᅀᆞᆯ	진
退	므를	퇴
儀	거도ᇰ	의
度	법돗	도
拜	절	ᄇᆡ
揖	읍ᄒᆞᆯ	읍
稽	니마조ᅀᆞᆯ	계
頓	니마조ᅀᆞᆯ	돈
拱	고ᄌᆞᆯ	고ᇰ
叉	거릴	차
跪	ᄭᅮᆯ	궤
跽	ᄭᅮᆯ	긔
行	녈	ᄒᆡᇰ
步	거름	보
坐	안ᄌᆞᆯ	좌
立	셜	립
俯	구블	부
仰	울월	아ᇰ
臥	누을	와
起	닐	긔
踐	ᄇᆞᆯ올	쳔
踏	ᄇᆞᆯ올	답
跐	즐ᄇᆞᆯ올	채
跑	ᄃᆞᄅᆞᆯ	포
蹲	줏그릴	준
距	줏구릴	거
跣	발바ᄉᆞᆯ	션
踣	업드를	븍
蹺	ᄒᆞᆫ 발 들	교
跬	ᄒᆞᆫ 발 옴길	규
蹶	거틸	궐
跌	거텨딜	딜
踴	봄놀	요ᇰ
躍	봄놀	약
跳	ᄠᅱ놀	됴
趯	ᄠᅱ놀	텩
窺	엿볼	규
覘	엿볼	뎜
顧	도라볼	고
看	볼	간
見	볼	견
視	볼	시
瞻	볼	쳠
覿	볼	뎍
覩	볼	도
覯	볼	구
覽	볼	람
觀	볼	관
瞰	볼	감
眺	볼	됴
瞬	눈 ᄀᆞᆷᄌᆞ길	슌
瞑	눈 ᄀᆞᄆᆞᆯ	며ᇰ
聾	귀 머글	로ᇰ
聵	귀 머글	훼
聰	귀 ᄇᆞᆯ글	초ᇰ
@	귀 울	호ᇰ
聽	드를	텨ᇰ
䎸	드를	오
聞	드를	문
聆	드를	려ᇰ
談	말ᄉᆞᆷ	담
話	말ᄉᆞᆷ	회
言	말ᄉᆞᆷ	언
語	말ᄉᆞᆷ	어
謇	말 구들	건
吃	혀 더틀	걸
訒	말 구들	ᅀᅵᆫ
訥	말구디ᄒᆞᆯ	눌
諫	간ᄒᆞᆯ	간
諍	간ᄒᆞᆯ	ᄌᆡᇰ
訐	허믈니ᄅᆞᆯ	알
訕	헐ᄲᅳ릴	산
說	니ᄅᆞᆯ	셜
謊	거즛말	화ᇰ
誘	달앨	유
訹	달앨	튤
諂	아다ᇰᄒᆞᆯ	텸
諛	아다ᇰᄒᆞᆯ	유
佞	말 잘ᄒᆞᆯ	녀ᇰ
辯	말 잘ᄒᆞᆯ	변
是	올ᄒᆞᆯ	시
非	욀	비
枉	구블	와ᇰ
直	고들	딕
謗	헐ᄲᅳ릴	바ᇰ
讟	헐ᄲᅳ릴	독
毁	헐ᄲᅳ릴	훼
譽	기릴	예
譏	비우ᅀᅳᆯ	긔
誚	구지즐	쵸
譴	허믈ᄒᆞᆯ	견
謮	구지즐	ᄎᆡᆨ
讒	하솟그릴	참
譖	하솟그릴	ᄎᆞᆷ
訴	할	소
告	고ᄒᆞᆯ	고
贓	자ᇰ믈	자ᇰ
證	마초ᄧᅳᆯ	즈ᇰ
誣	거즛	무
覈	마촐	ᄒᆡᆨ
黥	피조ᅀᆞᆯ	경
劓	고 버힐	의
剕	발 버힐	비
刖	발버힐	월
罪	허믈	죄
辜	죄	고
罰	죄줄	벌
謫	죄줄	뎍
打	틸	타
拷	틸	고
捶	틸	ᄎᆒ
撻	틸	달
趕	ᄧᅩ츨	한
逐	조ᄎᆞᆯ	튝
黜	내조츨	튤
斥	내틸	쳑
奸	간곡ᄒᆞᆯ	간
詐	간곡ᄒᆞᆯ	사
狡	간곡ᄒᆞᆯ	교
猾	간곡ᄒᆞᆯ	활
慳	앗길	간
悋	앗길	린
靳	븓 질긜	근
嗇	븓 질긜	ᄉᆡᆨ
懦	나ᄒᆞᇀ	나
弱	ᅀᅣᆨᄒᆞᆯ	ᅀᅣᆨ
迷	미혹ᄒᆞᆯ	미
劣	미혹ᄒᆞᆯ	렬
饕	탐ᄒᆞᆯ	도
餮	탐ᄒᆞᆯ	텰
貪	탐ᄒᆞᆯ	탐
婪	탐ᄒᆞᆯ	람
嬾	게으를	란
惰	게으를	타
懈	게으를	ᄒᆡ
怠	게으를	ᄐᆡ
愚	어릴	우
騃	어릴	애
癡	어릴	티
憨	어릴	함
好	됴ᄒᆞᆯ	호
@	사오나올	대
善	됴ᄒᆞᆯ	션
惡	모딜	악
能	어딜	느ᇰ
否	몯ᄒᆞᆯ	부
淑	됴ᄒᆞᆯ	슉
慝	사오나올	특
德	큰	덕
行	ᄒᆡᇰ뎍	ᄒᆡᇰ
學	ᄇᆡ올	ᄒᆞᆨ
業	일ᄒᆞᆯ	업
才	ᄌᆡ좃	ᄌᆡ
術	ᄌᆡ좃	슐
技	ᄌᆡ조	기
藝	ᄌᆡ조	예
職	벼술	직
任	맛ᄯᆞᆯ	ᅀᅵᆷ
資	부를	ᄌᆞ
級	서흐레	급
功	고ᇰ붓	고ᇰ
勣	고ᇰ노	젹
勳	고ᇰ노	훈
勩	잇블	예
刑	혀ᇰ벌	혀ᇰ
政	져ᇰᄉᆞᆺ	져ᇰ
事	일	ᄊᆞ
務	힘ᄡᅳᆯ	무
嚴	엄엄ᄒᆞᆯ	엄
威	위엄	위
恩	은혯	은
惠	은혯	혜
統	거느릴	토ᇰ
御	거느릴	어
攝	잡쥘	셥
理	다ᄉᆞ릴	리
撫	ᄆᆞᆫ질	무
恤	어엿블	휼
賑	쥐칠	진
濟	거느릴	졔
講	가ᇰᄒᆞᆯ	가ᇰ
誨	ᄀᆞᄅᆞ칠	회
敎	ᄀᆞᄅᆞ칠	교
訓	ᄀᆞᄅᆞ칠	훈
習	ᄇᆡ홀	습
諷	외올	푸ᇰ
誦	외올	쇼ᇰ
盟	ᄆᆡᇰ셧	ᄆᆡᇰ
誓	ᄆᆡᇰ솃	셰
@	바ᇰ법ᄒᆞᆯ	염
禳	야ᇰᄌᆡᄒᆞᆯ	야ᇰ
祈	빌	긔
禱	빌	도
讚	기릴	찬
頌	기릴	쇼ᇰ
謳	놀애	구
謠	놀애	요
吟	이플	음
嘯	ᄑᆞ람	쇼
問	무를	문
訊	무를	신
詞	말ᄉᆞᆷ	ᄉᆞ
訟	구의ᄒᆞᆯ	쇼ᇰ
嬖	ᄉᆞ라ᇰᄒᆞᆯ	폐
寵	ᄉᆞ라ᇰᄒᆞᆯ	툐ᇰ
姬	겨집	희
姜	겨집	가ᇰ
偎	ᄉᆞ라ᇰᄒᆞᆯ	외
愛	ᄃᆞᅀᆞᆯ	ᄋᆡ
矜	에엿블	그ᇰ
憐	에엿블	련
皴	ᄡᅵᇰ긜	쥰
皺	ᄡᅵᇰ긜	추
蚩	구즐	치
醜	더러울	ᄎᆔ
丰	푸ᇰᄎᆡ날	보ᇰ
艶	고을	염
嬌	얼울	교
姸	고을	연
伉	ᄀᆞᆯ올	하ᇰ
儷	ᄀᆞᆯ올	례
雙	두	솨ᇰ
對	ᄧᅡᆨ	ᄃᆡ
孑	ᄒᆞᆫ ᄑᆞᆯ 업슬	혈
隻	외ᄧᅡᆨ	쳑
孤	외로욀	고
獨	호을	독
一	ᄒᆞᆫ	일
壹	올	일
二	두	ᅀᅵ
貳	버글	ᅀᅵ
三	석	삼
四	넉	ᄉᆞ
五	다ᄉᆞᆺ	오
六	여슷	륙
七	닐굽	칠
八	여듧	팔
九	아홉	구
十	열	십
百	온	ᄇᆡᆨ
千	즈믄	쳔
萬	일만	만
億	억	억
分	ᄂᆞᆫ홀	분
兩	두	랴ᇰ
寸	ᄆᆞᄃᆡ	촌
斤	ᄂᆞᆯ	근
担	셤	단
托	바ᄅᆞᆷ	탁
咫	여듧 치	지
坼	ᄒᆞᆫ봄	ᄐᆡᆨ
左	욀	좌
右	올ᄒᆞᆯ	우
前	앏	젼
後	뒤	후
遐	멀	하
遠	멀	원
近	갓가올	근
邇	갓가올	ᅀᅵ
上	마ᄃᆡ	샤ᇰ
下	아래	하
內	안	ᄂᆡ
外	밧	외
中	가온ᄃᆡᆺ	듀ᇰ
間	슷	간
衷	솝	튜ᇰ
裏	솝	리
烟	ᄂᆡ	연
火	블	화
焚	브틀	분
燒	ᄉᆞᆯ	쇼
燄	븟곳	염
炸	븟벼록	자
煻	노을압	다ᇰ
煨	노을압	외
燬	블 브틀	훼
爇	블 브틀	셜
燎	블 브틀	료
燹	블 브틀	션
燼	블 님글	신
炷	븟 나올	주
灰	ᄌᆡ	회
炲	그ᅀᅳ름	ᄐᆡ
洚	큰믈	가ᇰ
水	믈	슈
瀰	ᄀᆞᄃᆞᆨᄒᆞᆯ	미
漫	펴딜	만
漲	한믈딜	탸ᇰ
濫	넘ᄯᅵᆯ	람
淹	ᄌᆞᄆᆞᆯ	엄
溺	ᄌᆞᄆᆞᆯ	닉
渾	얼읠	호
淪	얼읠	륜
汪	믈 너블	와ᇰ
濊	믈 너블	예
泯	스믤	민
滅	ᄢᅥ딜	멸
終	ᄆᆞᄎᆞᆷ	죠ᇰ
極	ᄀᆞ재	극
